NAME_OF_ISSUER,CUSIP,VALUE,SHRS_OR_PRN_AMT,SOLE_VOTING_AUTH,NO_VOTING_AUTH,TICKER
1347 PPTY INS HLDGS INC,68244P107,443,100562,91267,9295,
1ST CONSTITUTION BANCORP,31986N102,2359,125800,119245,6555,
1ST SOURCE CORP,336901103,15320,335014,319352,15662,
3M CO,88579Y101,17640,107300,61987,45313,
A10 NETWORKS INC,002121101,15770,2272400,2226300,46100,
AAR CORP,000361105,6955,168760,115277,53483,
ABBVIE INC,00287Y109,553263,7306698,5807801,1498897,
ABIOMED INC,003654100,379924,2135723,2025478,110245,
ABM INDS INC,000957100,3131,86200,19027,67173,
ABRAXAS PETE CORP,003830106,316,622920,0,622920,
ACACIA COMMUNICATIONS INC,00401C108,50129,766500,766500,0,
ACADIA PHARMACEUTICALS INC,004225108,3088,85800,52045,33755,
ACCO BRANDS CORP,00081T108,7852,795582,391843,403739,
ACCURAY INC,004397105,13547,4890509,4867600,22909,
ACHILLION PHARMACEUTICALS IN,00448Q201,13869,3852600,3718400,134200,
ACLARIS THERAPEUTICS INC,00461U105,2126,1968716,1968716,0,
ACME UTD CORP,004816104,3430,171300,159340,11960,
ACNB CORP,000868109,3139,91510,81618,9892,
ACORDA THERAPEUTICS INC,00484M106,11642,4056400,3877988,178412,
ACTINIUM PHARMACEUTICALS INC,00507W107,115,500573,500573,0,
ACUITY BRANDS INC,00508Y102,122524,909000,896367,12633,
ACUSHNET HOLDINGS CORP,005098108,296,11200,11200,0,
ADAMAS PHARMACEUTICALS INC,00548A106,632,123635,77162,46473,
ADDUS HOMECARE CORP,006739106,12607,159020,159020,0,
ADECOAGRO S A,L00849106,327,56100,0,56100,
ADESTO TECHNOLOGIES CORP,00687D101,1219,142400,4900,137500,
ADOBE INC,00724F101,14927,54033,19267,34766,
ADTALEM GLOBAL ED INC,00737L103,545,14300,1457,12843,
ADTRAN INC,00738A106,26287,2317028,2273516,43512,
ADURO BIOTECH INC,00739L101,2902,2738200,2590838,147362,ADRO
ADVANCE AUTO PARTS INC,00751Y106,6897,41700,41700,0,
ADVANCED DISP SVCS INC DEL,00790X101,37635,1155500,844611,310889,
ADVANCED DRAIN SYS INC DEL,00790R104,7009,217200,97901,119299,
ADVANCED ENERGY INDS,007973100,56791,989222,984851,4371,
ADVANCED MICRO DEVICES INC,007903107,18316,631795,393036,238759,
ADVANSIX INC,00773T101,10129,393800,393800,0,
ADVERUM BIOTECHNOLOGIES INC,00773U108,14677,2693000,2693000,0,
AECOM,00766T100,60520,1611277,1467623,143654,
AEGION CORP,00770F104,9910,463500,463500,0,
AEGLEA BIOTHERAPEUTICS INC,00773J103,4312,560700,560700,0,
AERIE PHARMACEUTICALS INC,00771V108,1634,85000,13073,71927,
AEROCENTURY CORP,007737109,190,30600,30600,0,
AEROJET ROCKETDYNE HLDGS INC,007800105,32569,644795,383988,260807,
AEROVIRONMENT INC,008073108,14940,278936,136188,142748,
AERPIO PHARMACEUTICALS INC,00810B105,109,160400,160400,0,
AES CORP,00130H105,174696,10691294,10341300,349994,
AETERNA ZENTARIS INC,007975402,80,77753,19169,58584,
AEVI GENOMIC MEDICINE INC,00835P105,359,2391788,2391788,0,
AFFILIATED MANAGERS GROUP IN,008252108,83825,1005700,1005700,0,
AGCO CORP,001084102,3732,49300,7690,41610,
AGILENT TECHNOLOGIES INC,00846U101,92071,1201500,1201500,0,
AGILE THERAPEUTICS INC,00847L100,2876,2427100,2427100,0,AGRX
AGILYSYS INC,00847J105,14249,556400,556400,0,
AGIOS PHARMACEUTICALS INC,00847X104,3920,121000,23946,97054,
AGNICO EAGLE MINES LTD,008474108,134780,2514035,2433081,80954,
AGROFRESH SOLUTIONS,00856G109,383,145503,145503,0,
AILERON THERAPEUTICS INC,00887A105,228,340248,340248,0,
AIRCASTLE LTD,G0129K104,3169,141300,0,141300,
AIRGAIN INC,00938A104,3717,316310,281092,35218,
AIR T INC,009207101,4010,213511,213511,0,
AIR TRANSPORT SERVICES GRP I,00922R105,1606,76400,76400,0,
AKAMAI TECHNOLOGIES INC,00971T101,3025,33100,33100,0,
AKEBIA THERAPEUTICS INC,00972D105,170,43427,163,43264,
AKORN INC,009728106,35925,9453869,8936402,517467,
AK STL HLDG CORP,001547108,11440,5039571,4447236,592335,
ALASKA AIR GROUP INC,011659109,10833,166900,166900,0,
ALASKA COMMUNICATIONS SYS GR,01167P101,4466,2596480,2473924,122556,
ALCOA CORP,013872106,130047,6479662,5941743,537919,AA
ALEXANDERS INC,014752109,48765,139964,127976,11988,
ALEXCO RESOURCE CORP,01535P106,1686,972585,664650,307935,
ALEXION PHARMACEUTICALS INC,015351109,279096,2849667,2849667,0,ALXN
ALGONQUIN PWR UTILS CORP,015857105,31582,2305261,2265761,39500,
ALICO INC,016230104,2906,85424,81105,4319,
ALIGN TECHNOLOGY INC,016255101,400901,2215900,2215900,0,
ALIMERA SCIENCES INC,016259103,620,1094208,1094208,0,
ALIO GOLD INC,01627X108,1031,1665789,1645010,20779,
ALLAKOS INC,01671P100,12793,162700,39875,122825,
ALLEGHANY CORP DEL,017175100,45702,57288,17737,39551,
ALLEGIANCE BANCSHARES INC,01748H107,2735,85240,85240,0,
ALLEGIANT TRAVEL CO,01748X102,14008,93600,39154,54446,
ALLENA PHARMACEUTICALS INC,018119107,498,126400,126400,0,
ALLIANT ENERGY CORP,018802108,104721,1941804,1517224,424580,
ALLIED MOTION TECHNOLOGIES I,019330109,8428,238700,238500,200,
ALLISON TRANSMISSION HLDGS I,01973R101,180731,3841260,3358002,483258,
ALLSTATE CORP,020002101,107387,988100,892281,95819,
ALLY FINL INC,02005N100,80542,2428900,1013451,1415449,
ALPHA PRO TECH LTD,020772109,3894,1078628,1058784,19844,
ALPINE IMMUNE SCIENCES INC,02083G100,445,112361,112361,0,
ALTRA INDL MOTION CORP,02208R106,3448,124509,14040,110469,
ALTRIA GROUP INC,02209S103,256807,6278900,1860915,4417985,
AMAG PHARMACEUTICALS INC,00163U106,23495,2034200,2034200,0,
A MARK PRECIOUS METALS INC,00181T107,371,30800,30800,0,
AMEDISYS INC,023436108,1454,11100,11100,0,
AMEREN CORP,023608102,448728,5605600,4828559,777041,
AMERICAN CAMPUS CMNTYS INC,024835100,7180,149328,114954,34374,
AMERICAN EAGLE OUTFITTERS IN,02553E106,88517,5457254,5457254,0,
AMERICAN ELEC PWR CO INC,025537101,455530,4862098,4862098,0,
AMERICAN EQTY INVT LIFE HLD,025676206,9254,382400,227942,154458,
AMERICAN EXPRESS CO,025816109,231888,1960500,573614,1386886,
AMERICAN FINL GROUP INC OHIO,025932104,85300,790915,680935,109980,
AMERICAN NATL BANKSHARES INC,027745108,6321,178200,178200,0,
AMERICAN NATL INS CO,028591105,21418,173100,166163,6937,
AMERICAN OUTDOOR BRANDS CORP,02874P103,20735,3544500,3544500,0,
AMERICAN PUBLIC EDUCATION IN,02913V103,28454,1273693,1241693,32000,
AMERICAN RENAL ASSOCIATES HO,029227105,5972,944975,867226,77749,
AMERICAN RIVER BANKSHARES,029326105,147,10662,6107,4555,
AMERICAN RLTY INVS INC,029174109,569,37000,37000,0,
AMERICAN SHARED HOSPITAL SVC,029595105,41,16200,6958,9242,
AMERICAN STS WTR CO,029899101,12162,135340,122260,13080,
AMERICAN TOWER CORP NEW,03027X100,336963,1523824,1523824,0,AMT
AMERICAN VANGUARD CORP,030371108,7663,488100,488100,0,
AMERICAN WOODMARK CORPORATIO,030506109,2036,22901,19368,3533,AMWD
AMERICAN WTR WKS CO INC NEW,030420103,5590,45000,45000,0,
AMERICAS CAR MART INC,03062T105,1721,18772,0,18772,
AMERICOLD RLTY TR,03064D108,33641,907500,612478,295022,
AMERIPRISE FINL INC,03076C106,16666,113300,10228,103072,
AMERISAFE INC,03071H100,17393,263093,225886,37207,
AMERISERV FINL INC,03074A102,3165,764444,752450,11994,
AMES NATL CORP,031001100,3691,129000,124728,4272,
AMETEK INC NEW,031100100,48476,527950,84281,443669,
AMGEN INC,031162100,707876,3658086,3146770,511316,
AMICUS THERAPEUTICS INC,03152W109,11796,1470800,266544,1204256,
AMKOR TECHNOLOGY INC,031652100,21507,2363400,2284756,78644,
AMPCO-PITTSBURGH CORP,032037103,1800,489024,489024,0,
AMPHASTAR PHARMACEUTICALS IN,03209R103,14490,730700,730700,0,
AMPIO PHARMACEUTICALS INC,03209T109,88,175300,0,175300,
AMPLIFY ENERGY CORP NEW,03212B103,1799,291600,291600,0,
AMREP CORP NEW,032159105,756,132280,130680,1600,
ANAPLAN INC,03272L108,2613,55586,32980,22606,PLAN
ANDERSONS INC,034164103,9743,434376,432800,1576,
ANGIODYNAMICS INC,03475V101,9320,505946,378126,127820,
ANIKA THERAPEUTICS INC,035255108,26508,482922,476910,6012,
ANI PHARMACEUTICALS INC,00182C103,24284,333200,333200,0,
ANIXTER INTL INC,035290105,6000,86800,57543,29257,
ANNALY CAP MGMT INC,035710409,32905,3739200,3739200,0,
ANTARES PHARMA INC,036642106,429,128128,0,128128,
ANTERO RES CORP,03674X106,13339,4416797,1373119,3043678,
ANTHEM INC,036752103,123429,514073,146190,367883,
ANWORTH MORTGAGE ASSET CP,037347101,21654,6561690,6561690,0,
APHRIA INC,03765K104,1673,321900,700,321200,
APOLLO COML REAL EST FIN INC,03762U105,14581,760640,446500,314140,
APOLLO ENDOSURGERY INC,03767D108,270,82100,82100,0,
APPLE INC,037833100,37106,165676,126525,39151,
APPLIED GENETIC TECHNOL CORP,03820J100,4372,1051060,1041360,9700,
APPLIED INDL TECHNOLOGIES IN,03820C105,7756,136550,46122,90428,
APTARGROUP INC,038336103,14155,119500,30962,88538,
APTEVO THERAPEUTICS INC,03835L108,1275,2167335,2167335,0,
APTINYX INC,03836N103,308,88200,69298,18902,
APYX MED CORP,03837C106,4419,652800,652800,0,
ARAVIVE INC,03890D108,1295,172659,172565,94,
ARBOR RLTY TR INC,038923108,5473,417440,121829,295611,
ARBUTUS BIOPHARMA CORP,03879J100,257,168312,0,168312,
ARCA BIOPHARMA INC,00211Y506,535,100088,100088,0,
ARCBEST CORP,03937C105,2376,78035,60955,17080,
ARC DOCUMENT SOLUTIONS INC,00191G103,4749,3491774,3426713,65061,
ARCHROCK INC,03957W106,1804,180900,180900,0,
ARCONIC INC,03965L100,38212,1469700,1469700,0,
ARCOSA INC,039653100,281,8200,1873,6327,
ARCTURUS THERAPEUTICS HLDG I,03969T109,334,32500,0,32500,
ARCUS BIOSCIENCES INC,03969F109,1282,140838,140838,0,
ARDELYX INC,039697107,11431,2432134,2432134,0,
ARDMORE SHIPPING CORP,Y0207T100,4519,675498,613798,61700,
ARES COML REAL ESTATE CORP,04013V108,1465,96200,47,96153,
ARGAN INC,04010E109,25955,660600,660600,0,
ARGO GROUP INTL HLDGS LTD,G0464B107,2716,38665,38587,78,
ARISTA NETWORKS INC,040413106,77243,323300,323300,0,
ARK RESTAURANTS CORP,040712101,1843,88205,87400,805,
ARMADA HOFFLER PPTYS INC,04208T108,67550,3734109,3638809,95300,
ARMATA PHARMACEUTICALS INC,04216R102,280,75654,75654,0,
ARMSTRONG FLOORING INC,04238R106,2019,315966,283000,32966,
ARMSTRONG WORLD INDS INC NEW,04247X102,91101,942100,771379,170721,
ARQULE INC,04269E107,4740,661073,367691,293382,
ARROW FINL CORP,042744102,12616,377823,376524,1299,
ARROWHEAD PHARMACEUTICALS IN,04280A100,18531,657600,311385,346215,
ARTS WAY MFG INC,043168103,36,16600,16600,0,
ASANKO GOLD INC,04341Y105,5096,5570812,5160812,410000,
ASCENA RETAIL GROUP INC,04351G101,1552,5875400,5875400,0,
ASHFORD INC,044104107,872,35975,30022,5953,
ASHLAND GLOBAL HLDGS INC,044186104,31180,404675,153103,251572,
ASPEN AEROGELS INC,04523Y105,3372,569531,569531,0,
ASPEN TECHNOLOGY INC,045327103,292672,2377903,2295514,82389,
ASSEMBLY BIOSCIENCES INC,045396108,1229,124991,64041,60950,
ASSERTIO THERAPEUTICS INC,04545L107,7330,5726289,5726289,0,
ASSOCIATED BANC CORP,045487105,11960,590631,446825,143806,
ASSURANT INC,04621X108,133797,1063400,914239,149161,AIZ
ASSURED GUARANTY LTD,G0585R106,4268,96000,29734,66266,
ASTA FDG INC,046220109,149,21219,20309,910,
ASTEC INDS INC,046224101,493,15845,0,15845,
ASTRONOVA INC,04638F108,4056,250850,223450,27400,
ATHENEX INC,04685N103,624,51300,0,51300,
ATHERSYS INC,04744L106,1339,1006926,1006926,0,
ATKORE INTL GROUP INC,047649108,8046,265100,162625,102475,
ATLANTIC AMERN CORP,048209100,148,53300,53300,0,
ATLANTIC CAP BANCSHARES INC,048269203,7649,441108,377508,63600,
ATLANTIC UN BANKSHARES CORP,04911A107,18120,486502,486502,0,
ATLANTICUS HLDGS CORP,04914Y102,706,84601,84601,0,
ATMOS ENERGY CORP,049560105,6025,52900,750,52150,
ATN INTL INC,00215F107,40888,700500,688500,12000,
ATRICURE INC,04963C209,5175,207500,207500,0,
ATRION CORP,049904105,46516,59700,56100,3600,
AUBURN NATL BANCORP,050473107,303,6400,5655,745,
AUDENTES THERAPEUTICS INC,05070R104,2211,78700,18530,60170,
AURINIA PHARMACEUTICALS INC,05156V102,57,10745,10745,0,
AURORA CANNABIS INC,05156X108,10020,2278895,710700,1568195,
AURYN RES INC,05208W108,438,360700,81187,279513,
AUTOMATIC DATA PROCESSING IN,053015103,122824,760900,183007,577893,
AUTONATION INC,05329W102,18029,355600,146062,209538,
AUTOWEB INC,05335B100,1294,417390,417390,0,
AUTOZONE INC,053332102,185253,170800,63084,107716,
AVALARA INC,05338G106,165768,2463480,1769787,693693,
AVALONBAY CMNTYS INC,053484101,127543,592314,567423,24891,
AVANGRID INC,05351W103,57619,1102755,1020596,82159,
AVERY DENNISON CORP,053611109,5940,52300,17591,34709,
AVID BIOSERVICES INC,05368M106,959,181006,181006,0,
AVID TECHNOLOGY INC,05367P100,3935,635667,635667,0,
AVINGER INC,053734604,173,208420,208420,0,
AVINO SILVER & GOLD MINES LT,053906103,191,326307,235618,90689,
AVIS BUDGET GROUP INC,053774105,100052,3540400,3540400,0,
AVISTA CORP,05379B107,102752,2121218,2121218,0,
AVNET INC,053807103,33964,763500,335736,427764,
AVON PRODS INC,054303102,104161,23672978,23317778,355200,
AVX CORP NEW,002444107,2446,160900,83900,77000,
AWARE INC MASS,05453N100,2591,866511,861894,4617,
AXA EQUITABLE HLDGS INC,054561105,25497,1150600,756252,394348,
AXALTA COATING SYS LTD,G0750C108,152646,5062877,4391701,671176,
AXOGEN INC,05463X106,1474,118100,35225,82875,
AXOVANT GENE THERAPIES LTD,G0750W203,1796,278023,278023,0,
AXT INC,00246W103,598,168000,21430,146570,
AZURRX BIOPHARMA INC,05502L105,14,22800,0,22800,
AZZ INC,002474104,11672,267963,223734,44229,
B2GOLD CORP,11777Q209,110380,34161891,29614216,4547675,
BABCOCK & WILCOX ENTERPRIS I,05614L209,1270,265180,265180,0,
BALCHEM CORP,057665200,23043,232308,232308,0,
BALLANTYNE STRONG INC,058516105,1901,611203,608691,2512,
BALLARD PWR SYS INC NEW,058586108,1837,375800,69400,306400,
BANCFIRST CORP,05945F103,13274,239524,232392,7132,
BANC OF CALIFORNIA INC,05990K106,8142,575825,570973,4852,
BANCORP INC DEL,05969A105,7992,807300,750605,56695,
BANCORP NEW JERSEY INC NEW,059915108,307,18200,11208,6992,
BANK AMER CORP,060505104,25234,865066,794125,70941,
BANK COMM HLDGS,06424J103,1414,129800,103808,25992,BOCH
BANKFINANCIAL CORP,06643P104,12616,1060200,991681,68519,
BANK HAWAII CORP,062540109,40989,477000,477000,0,
BANK MONTREAL QUE,063671101,23114,313445,221858,91587,
BANK N S HALIFAX,064149107,260993,4590900,4484863,106037,
BANK OF MARIN BANCORP,063425102,10784,259911,237873,22038,
BANK OZK,06417N103,42789,1569092,1443432,125660,
BANK PRINCETON NEW JERSEY,064520109,1419,48823,48823,0,
BANKUNITED INC,06652K103,18552,551800,305495,246305,
BANKWELL FINL GROUP INC,06654A103,5346,194400,194400,0,
BAR HBR BANKSHARES,066849100,6343,254450,254450,0,
BARNWELL INDS INC,068221100,73,139644,139644,0,
BARRETT BUSINESS SERVICES IN,068463108,35768,402700,385107,17593,
BARRICK GOLD CORPORATION,067901108,260338,15022365,14534520,487845,
BASSETT FURNITURE INDS INC,070203104,11882,776605,772689,3916,
BAUSCH HEALTH COS INC,071734107,110614,5062403,5062403,0,
BAYTEX ENERGY CORP,07317Q105,977,660297,170717,489580,
BBQ HLDGS INC,05551A109,2319,474247,473037,1210,
BB&T CORP,054937107,25632,480262,447691,32571,
BCB BANCORP INC,055298103,6151,479076,455706,23370,
BED BATH & BEYOND INC,075896100,10360,973660,445564,528096,
BELDEN INC,077454106,10790,202293,202293,0,
BELLEROPHON THERAPEUTICS INC,078771102,751,1557803,1557803,0,
BELLICUM PHARMACEUTICALS INC,079481107,2731,2601064,1991662,609402,
BENCHMARK ELECTRS INC,08160H101,16079,553300,553300,0,
BERKSHIRE HILLS BANCORP INC,084680107,13957,476523,460074,16449,
BEST BUY INC,086516101,120845,1751630,1751630,0,
BG STAFFING INC,05544A109,720,37700,37700,0,
BIG 5 SPORTING GOODS CORP,08915P101,143,68644,10100,58544,
BIG LOTS INC,089302103,2499,102000,102000,0,
BIOANALYTICAL SYS INC,09058M103,1201,334502,330649,3853,
BIOCRYST PHARMACEUTICALS,09058V103,604,210815,0,210815,
BIODELIVERY SCIENCES INTL IN,09060J106,609,144700,44298,100402,
BIOGEN INC,09062X103,982781,4221206,3893042,328164,
BIOMARIN PHARMACEUTICAL INC,09061G101,37479,556071,118692,437379,
BIO PATH HOLDINGS INC,09057N300,444,46694,46694,0,
BIOSPECIFICS TECHNOLOGIES CO,090931106,30578,571347,553047,18300,
BIO TECHNE CORP,09073M104,110968,567120,493929,73191,
BIOXCEL THERAPEUTICS INC,09075P105,547,77700,77700,0,
BJS WHSL CLUB HLDGS INC,05550J101,10881,420600,93008,327592,
BK TECHNOLOGIES CORPORATION,05587G104,2137,636100,635623,477,
BLACKBERRY LTD,09228F103,19374,3690344,3690344,0,BB
BLACK HILLS CORP,092113109,106648,1389915,1389915,0,
BLACK KNIGHT INC,09215C105,2875,47078,1415,45663,
BLACKLINE INC,09239B109,6019,125900,18806,107094,
BLONDER TONGUE LABS INC,093698108,47,71057,71057,0,
BLUCORA INC,095229100,59908,2768400,2768200,200,
BLUE BIRD CORP,095306106,9434,495600,495600,0,
BLUE CAP REINS HLDGS LTD,G1190F107,2225,301900,284580,17320,
BMC STK HLDGS INC,05591B109,34168,1305100,1175955,129145,BMCH
BOEING CO,097023105,29182,76700,16348,60352,
BOINGO WIRELESS INC,09739C102,28283,2548000,2548000,0,
BOISE CASCADE CO DEL,09739D100,5058,155200,136402,18798,
BOOKING HLDGS INC,09857L108,25904,13199,5653,7546,
BOOT BARN HLDGS INC,099406100,13747,393900,297559,96341,
BORGWARNER INC,099724106,9915,270300,78437,191863,
BOSTON OMAHA CORP,101044105,579,29200,0,29200,
BOSTON PRIVATE FINL HLDGS IN,101119105,9625,825800,825800,0,
BOSTON PROPERTIES INC,101121101,38315,295500,24535,270965,BXP
BOTTOMLINE TECH DEL INC,101388106,8387,213142,168383,44759,
BOYD GAMING CORP,103304101,5056,211100,23031,188069,
BRAEMAR HOTELS & RESORTS INC,10482B101,4933,525375,525375,0,
BRICKELL BIOTECH INC,10802T105,1106,265153,265153,0,
BRIDGE BANCORP INC,108035106,8300,280800,279300,1500,
BRIGGS & STRATTON CORP,109043109,2383,393300,274650,118650,
BRIGHTCOVE INC,10921T101,23400,2232832,2122151,110681,
BRIGHT HORIZONS FAM SOL IN D,109194100,14198,93100,7162,85938,
BRIGHTHOUSE FINL INC,10922N103,12756,315200,99034,216166,BHF
B RILEY FINL INC,05580M108,430,18200,18200,0,
BRINKER INTL INC,109641100,486,11400,0,11400,
BRISTOL MYERS SQUIBB CO,110122108,1661147,32757770,28224283,4533487,
BRIXMOR PPTY GROUP INC,11120U105,85112,4194800,4194800,0,
BROADRIDGE FINL SOLUTIONS IN,11133T103,27300,219400,38208,181192,
BROOKDALE SR LIVING INC,112463104,98467,12990325,12795661,194664,
BROOKLINE BANCORP INC DEL,11373M107,26818,1820640,1768351,52289,
BROWN & BROWN INC,115236101,95314,2643200,2544412,98788,
BRT APARTMENTS CORP,055645303,9222,632542,578592,53950,
BRUNSWICK CORP,117043109,12097,232100,56960,175140,
BRYN MAWR BK CORP,117665109,28935,792520,785692,6828,
BUCKLE INC,118440106,16024,777850,706651,71199,
BUILD A BEAR WORKSHOP,120076104,2652,841966,841966,0,
BUILDERS FIRSTSOURCE INC,12008R107,56213,2732100,2606509,125591,BLDR
BUNGE LIMITED,G16962105,34385,607300,185932,421368,
BURLINGTON STORES INC,122017106,94021,470527,161292,309235,
BUSINESS FIRST BANCSHARES IN,12326C105,200,8204,8204,0,BFST
BYLINE BANCORP INC,124411109,3871,216500,199342,17158,
CABLE ONE INC,12685J105,362985,289300,259793,29507,
CABOT MICROELECTRONICS CORP,12709P103,95661,677439,677439,0,
CABOT OIL & GAS CORP,127097103,1407,80100,80100,0,
CADENCE DESIGN SYSTEM INC,127387108,59389,898744,264377,634367,
CAE INC,124765108,49650,1954546,1843800,110746,
CAESARS ENTMT CORP,127686103,76978,6601885,1972954,4628931,
CALAMP CORP,128126109,12748,1106601,1088087,18514,
CALAVO GROWERS INC,128246105,30355,318920,245356,73564,
CALIFORNIA WTR SVC GROUP,130788102,6648,125600,26425,99175,
CALITHERA BIOSCIENCES INC,13089P101,3334,1078803,1078803,0,
CALIX INC,13100M509,17885,2798918,2794500,4418,
CALYXT INC,13173L107,220,38930,0,38930,
CAMBREX CORP,132011107,10484,176200,42755,133445,
CAMBRIDGE BANCORP,132152109,953,12700,12700,0,
CAMDEN NATL CORP,133034108,21175,488800,483549,5251,
CAMECO CORP,13321L108,116,12200,12200,0,
CAMPBELL SOUP CO,134429109,4138,88200,88200,0,CPB
CANADIAN NATL RY CO,136375102,27290,303700,114400,189300,
CANADIAN NAT RES LTD,136385101,14017,526354,71160,455194,
CANADIAN PAC RY LTD,13645T100,13837,62200,1758,60442,
CANCER GENETICS INC,13739U104,391,3795263,3795263,0,
CANNAE HLDGS INC,13765N107,4802,174800,169400,5400,
CANNTRUST HLDGS INC,137800207,118,104700,33600,71100,
CANOPY GROWTH CORP,138035100,11714,510900,281800,229100,
CAPITAL BANCORP INC MD,139737100,292,21404,15691,5713,
CAPITAL CITY BK GROUP INC,139674105,6600,240429,240429,0,
CAPITAL ONE FINL CORP,14040H105,782,8600,8600,0,
CAPITAL SR LIVING CORP,140475104,5405,1234121,1234121,0,
CAPITOL FED FINL INC,14057J101,115448,8377958,8377958,0,
CAPSTAR FINL HLDGS INC,14070T102,5494,331367,264602,66765,
CARBO CERAMICS INC,140781105,5376,2239854,2239854,0,
CARBON BLACK INC,14081R103,19945,767400,585534,181866,
CARBONITE INC,141337105,441,28500,28500,0,
CARDINAL HEALTH INC,14149Y108,94131,1994720,1924859,69861,
CARDIOVASCULAR SYS INC DEL,141619106,70197,1477200,1370625,106575,
CARDLYTICS INC,14161W105,3450,102935,19404,83531,
CARE COM INC,141633107,25436,2434100,2351600,82500,
CAREDX INC,14167L103,5585,247000,33756,213244,
CAREER EDUCATION CORP,141665109,76249,4798563,4592703,205860,
CARETRUST REIT INC,14174T107,13490,573900,396490,177410,
CARLISLE COS INC,142339100,35323,242700,46620,196080,
CARMAX INC,143130102,40850,464200,78774,385426,
CAROLINA FINL CORP NEW,143873107,17980,505916,505916,0,
CAROLINA TR BANCSHARES INC,14422P105,288,27500,16750,10750,
CARRIAGE SVCS INC,143905107,25714,1258000,1258000,0,
CARROLS RESTAURANT GROUP INC,14574X104,1975,238200,238200,0,
CASA SYS INC,14713L102,3842,489100,489100,0,
CASSAVA SCIENCES INC,14817C107,1022,851958,851958,0,
CASS INFORMATION SYS INC,14808P109,4346,80489,80489,0,
CATALENT INC,148806102,24354,511000,205178,305822,
CATERPILLAR INC DEL,149123101,15739,124604,124304,300,
CATHAY GEN BANCORP,149150104,3396,97771,84884,12887,
CAVCO INDS INC DEL,149568107,23131,120415,113630,6785,
CBAK ENERGY TECHNOLOGY INC,14986C102,70,115620,115620,0,
CB FINL SVCS INC,12479G101,1735,62517,38914,23603,
CBIZ INC,124805102,14632,622626,599200,23426,
CBL & ASSOC PPTYS INC,124830100,5692,4412016,4412016,0,CBL
CBM BANCORP INC,1248XT104,174,12400,7403,4997,
CBOE GLOBAL MARKETS INC,12503M108,531637,4626553,4626553,0,
CBTX INC,12481V104,1347,48300,38200,10100,
CDK GLOBAL INC,12508E101,21703,451300,246799,204501,
CDN IMPERIAL BK COMM TORONTO,136069101,131325,1590664,1501558,89106,
CDW CORP,12514G108,64396,522525,522525,0,
CECO ENVIRONMENTAL CORP,125141101,1604,229683,219800,9883,
CELGENE CORP,151020104,1543789,15546716,15513678,33038,
CENOVUS ENERGY INC,15135U109,19671,2095600,385956,1709644,
CENTENE CORP DEL,15135B101,101299,2341632,420371,1921261,
CENTERPOINT ENERGY INC,15189T107,149708,4960500,4335645,624855,
CENTERSTATE BK CORP,15201P109,36336,1514942,1514942,0,
CENTRAL GARDEN & PET CO,153527106,12574,430185,415000,15185,
CENTRAL VALLEY CMNTY BANCORP,155685100,3225,158481,154117,4364,
CENTRIC BRANDS INC,15644G104,107,42435,42435,0,
CENTURY CASINOS INC,156492100,8533,1103866,950266,153600,
CENTURYLINK INC,156700106,12165,974757,974757,0,
CERIDIAN HCM HLDG INC,15677J108,414,8400,4600,3800,
CERNER CORP,156782104,10437,153104,15788,137316,
CESCA THERAPEUTICS INC,157131301,825,124445,124445,0,
CEVA INC,157210105,9128,305700,278300,27400,
C & F FINL CORP,12466Q104,7525,142900,139340,3560,
CF INDS HLDGS INC,125269100,28848,586350,254535,331815,
CHANNELADVISOR CORP,159179100,4064,435600,375747,59853,
CHANTICLEER HLDGS INC,15930P800,49,67307,67307,0,
CHARAH SOLUTIONS INC,15957P105,22,10300,10300,0,
CHARLES & COLVARD LTD,159765106,1187,728037,463049,264988,
CHARLES RIV LABS INTL INC,159864107,192821,1456683,1456683,0,CRL
CHASE CORP,16150R104,42520,388700,388700,0,
CHATHAM LODGING TR,16208T102,35572,1959876,1959876,0,
CHECKPOINT THERAPEUTICS INC,162828107,315,126404,126404,0,
CHEFS WHSE INC,163086101,54686,1356300,1356300,0,
CHEGG INC,163092109,17718,591600,230020,361580,
CHEMED CORP NEW,16359R103,80633,193100,193100,0,
CHEMOCENTRYX INC,16383L106,8787,1295979,1251681,44298,
CHEMOURS CO,163851108,4642,310700,33398,277302,
CHEMUNG FINL CORP,164024101,3624,86288,79517,6771,
CHERRY HILL MTG INVT CORP,164651101,8492,648258,648258,0,
CHESAPEAKE UTILS CORP,165303108,24064,252450,252450,0,
CHEVRON CORP NEW,166764100,57460,484484,14326,470158,CVX
CHIASMA INC,16706W102,2804,566423,566423,0,
CHICAGO RIVET & MACH CO,168088102,1689,63810,63810,0,
CHICOS FAS INC,168615102,33914,8415300,8415300,0,
CHIMERIX INC,16934W106,5404,2299627,2153670,145957,
CHINA AUTOMOTIVE SYS INC,16936R105,714,350091,350091,0,
CHINA BIOLOGIC PRODS HLDGS I,G21515104,1717,15000,15000,0,
CHINA CUST RELATIONS CNTR IN,G2118P102,301,18806,18806,0,
CHINA NATURAL RESOURCES INC,G2110U109,23,12315,11900,415,
CHINA PHARMA HLDGS INC,16941T104,179,731457,731457,0,
CHINA XD PLASTICS CO LTD,16948F107,1227,645980,629467,16513,
CHINA YUCHAI INTL LTD,G21082105,6537,504754,446394,58360,CYD
CHIPOTLE MEXICAN GRILL INC,169656105,1609031,1914442,1756732,157710,
CHOICE HOTELS INTL INC,169905106,13593,152800,38578,114222,
CHURCH & DWIGHT INC,171340102,50087,665700,665700,0,
CHURCHILL DOWNS INC,171484108,10608,85925,24268,61657,
CHUYS HLDGS INC,171604101,6534,263900,241800,22100,
CIDARA THERAPEUTICS INC,171757107,1348,675688,675688,0,
CINCINNATI FINL CORP,172062101,665,5700,0,5700,
CINEMARK HOLDINGS INC,17243V102,142674,3692400,3692400,0,
CINTAS CORP,172908105,111467,415768,138235,277533,
CIRRUS LOGIC INC,172755100,9297,173520,24744,148776,
CISCO SYS INC,17275R102,113470,2296505,32603,2263902,
CITI TRENDS INC,17306X102,8643,472290,421800,50490,
CITIZENS CMNTY BANCORP INC M,174903104,275,24800,8264,16536,
CITIZENS FINL GROUP INC,174610105,32081,907000,209303,697697,
CITIZENS HLDG CO MISS,174715102,383,18800,18800,0,
CITIZENS & NORTHN CORP,172922106,5617,213721,212060,1661,
CITY HLDG CO,177835105,408,5355,4967,388,
CITY OFFICE REIT INC,178587101,43845,3046899,2634537,412362,
CIVEO CORP CDA,17878Y108,11037,8690672,8690672,0,
C&J ENERGY SVCS INC NEW,12674R100,20737,1932600,1834492,98108,
CLARUS CORP NEW,18270P109,10701,912647,905841,6806,
CLEAN ENERGY FUELS CORP,184499101,19795,9585839,9219434,366405,
CLEAN HARBORS INC,184496107,136721,1771002,1606455,164547,
CLEAR CHANNEL OUTDOOR HLDGS,18453H106,2916,1157049,1157049,0,
CLEARFIELD INC,18482P103,6682,563899,563899,0,
CLEARONE INC,18506U104,468,258275,258275,0,
CLIPPER RLTY INC,18885T306,2602,255357,241050,14307,
CLOROX CO DEL,189054109,181423,1194594,1194594,0,
CLPS INCORPORATION,G31642104,80,15800,9667,6133,
CME GROUP INC,12572Q105,342840,1622219,1622219,0,
CMS ENERGY CORP,125896100,150858,2359000,2359000,0,
CNA FINL CORP,126117100,50540,1026200,1016983,9217,
CNB FINL CORP PA,126128107,9253,322402,317206,5196,
CNO FINL GROUP INC,12621E103,15097,953700,687703,265997,
COCA COLA CO,191216100,155922,2864100,300558,2563542,
COCA COLA CONSOLIDATED INC,191098102,1346,4429,158,4271,
CODORUS VY BANCORP INC,192025104,3717,159797,143542,16255,
COFFEE HLDG CO INC,192176105,1393,356222,339270,16952,JVA
COHEN & STEERS INC,19247A100,2543,46300,46017,283,
COHU INC,192576106,17895,1325054,1315100,9954,
COLGATE PALMOLIVE CO,194162103,335406,4562727,4390077,172650,
COLLEGIUM PHARMACEUTICAL INC,19459J104,8578,747200,747200,0,
COLONY BANKCORP INC,19623P101,1593,103811,96888,6923,
COLUMBIA FINL INC,197641103,8014,507564,481133,26431,
COLUMBIA SPORTSWEAR CO,198516106,1580,16302,3177,13125,
COLUMBUS MCKINNON CORP N Y,199333105,8754,240300,240300,0,
COMMERCE BANCSHARES INC,200525103,6217,102498,88634,13864,
COMMERCIAL VEH GROUP INC,202608105,15414,2137800,2137800,0,
COMMSCOPE HLDG CO INC,20337X109,2178,185200,30029,155171,
COMMUNICATIONS SYS INC,203900105,2615,572180,548392,23788,
COMMUNITY BANKERS TR CORP,203612106,1650,191907,180583,11324,
COMMUNITY BK SYS INC,203607106,679,11008,5741,5267,
COMMUNITY FINL CORP MD,20368X101,2360,70514,58510,12004,
COMMUNITY FIRST BANCSHARES I,20369M104,680,66750,56581,10169,
COMMUNITY HEALTH SYS INC NEW,203668108,1869,519144,345711,173433,
COMMUNITY TR BANCORP INC,204149108,14583,342482,338933,3549,
COMMVAULT SYSTEMS INC,204166102,98379,2200387,2075867,124520,
COMPUTER PROGRAMS & SYS INC,205306103,671,29676,4900,24776,
COMPUTER TASK GROUP INC,205477102,5070,1013996,902322,111674,
COMSCORE INC,20564W105,2100,1099539,1099539,0,
COMSTOCK RES INC,205768302,1704,218800,123497,95303,
CONAGRA BRANDS INC,205887102,11315,368800,368800,0,
CONCERT PHARMACEUTICALS INC,206022105,3633,617790,604395,13395,
CONDUENT INC,206787103,28677,4610500,2321706,2288794,
CONFORMIS INC,20717E101,9614,5168883,5168883,0,
CONNECTICUT WTR SVC INC,207797101,26637,380199,332281,47918,
CONNECTONE BANCORP INC NEW,20786W107,23694,1067276,1042780,24496,
CONOCOPHILLIPS,20825C104,68526,1202636,105323,1097313,
CONSOL ENERGY INC NEW,20854L108,5797,370900,370900,0,
CONSOLIDATED COMM HLDGS INC,209034107,66,13800,13800,0,
CONSOLIDATED EDISON INC,209115104,404369,4280400,4280400,0,
CONSOLIDATED TOMOKA LD CO,210226106,3870,59000,35700,23300,
CONSUMER PORTFOLIO SVCS INC,210502100,1332,370908,370109,799,
CONTAINER STORE GROUP INC,210751103,1725,390250,390250,0,
CONTINENTAL BLDG PRODS INC,211171103,5382,197200,197200,0,
CONTINENTAL RESOURCES INC,212015101,21362,693800,693800,0,
CONTRAFECT CORP,212326102,176,491610,491610,0,
CONTURA ENERGY INC,21241B100,3022,108100,108100,0,
COOPER TIRE & RUBR CO,216831107,2474,94700,94700,0,
COPART INC,217204106,49989,622300,80224,542076,
CORCEPT THERAPEUTICS INC,218352102,92220,6524209,6524209,0,
CORECIVIC INC,21871N101,87210,5046903,4897852,149051,
CORELOGIC INC,21871D103,45678,987200,987200,0,
CORE MARK HOLDING CO INC,218681104,16815,523592,426323,97269,
CORE MOLDING TECHNOLOGIES IN,218683100,3450,538213,533066,5147,
COREPOINT LODGING INC,21872L104,4212,416600,416600,0,
CORESITE RLTY CORP,21870Q105,127492,1046300,1046300,0,
CORINDUS VASCULAR ROBOTICS I,218730109,376,87900,281,87619,
CORNERSTONE BLDG BRANDS INC,21925D109,15313,2531000,2531000,0,
CORNERSTONE ONDEMAND INC,21925Y103,15437,281600,253148,28452,
CORREVIO PHARMA CORP,22026V105,1058,528975,527975,1000,
CORVEL CORP,221006109,100879,1332610,1327010,5600,
CORVUS PHARMACEUTICALS INC,221015100,2564,851778,815400,36378,
COSTCO WHSL CORP NEW,22160K105,133370,462913,199816,263097,
COTT CORP QUE,22163N106,28693,2301002,2112987,188015,
COUNTY BANCORP INC,221907108,983,50113,30200,19913,
COUPA SOFTWARE INC,22266L106,28454,219604,12645,206959,
COVANTA HLDG CORP,22282E102,25147,1454400,1454400,0,
COVIA HLDGS CORP,22305A103,1653,818499,818499,0,
CRACKER BARREL OLD CTRY STOR,22410J106,45807,281632,182809,98823,
CRAFT BREW ALLIANCE INC,224122101,1376,168048,118093,49955,
CRA INTL INC,12618T105,18743,446575,419444,27131,
CRANE CO,224399105,6837,84800,42489,42311,
CREDIT ACCEP CORP MICH,225310101,25136,54488,15137,39351,
CREE INC,225447101,52564,1072742,584690,488052,
CRESCENT PT ENERGY CORP,22576C101,15717,3679446,985400,2694046,
CRH MEDICAL CORP,12626F105,2112,685600,575142,110458,
CROCS INC,227046109,104097,3749900,3710005,39895,
CRONOS GROUP INC,22717L101,904,100000,40000,60000,
CROSS CTRY HEALTHCARE INC,227483104,2390,232000,232000,0,
CROWN CASTLE INTL CORP NEW,22822V101,372018,2676199,2676199,0,
CROWN CRAFTS INC,228309100,2000,320000,320000,0,
CRYOLIFE INC,228903100,2528,93100,50300,42800,
CSG SYS INTL INC,126349109,119863,2319324,2300017,19307,
CSP INC,126389105,3419,254750,240050,14700,
CSS INDS INC,125906107,1188,299119,299119,0,
CSW INDUSTRIALS INC,126402106,13268,192200,172955,19245,
CSX CORP,126408103,180913,2611706,2611706,0,
CTI BIOPHARMA CORP,12648L601,1572,1877889,1877889,0,
CTS CORP,126501105,8187,253000,253000,0,
CUBESMART,229663109,12972,371700,210044,161656,
CULLEN FROST BANKERS INC,229899109,19897,224700,171333,53367,
CULP INC,230215105,12399,760700,760700,0,
CUMBERLAND PHARMACEUTICALS I,230770109,2782,469138,454224,14914,
CURO GROUP HLDGS CORP,23131L107,260,19600,0,19600,
CURTISS WRIGHT CORP,231561101,440,3400,336,3064,
CUSTOMERS BANCORP INC,23204G100,515,24820,15500,9320,
CUTERA INC,232109108,19263,659000,659000,0,CUTR
CVB FINL CORP,126600105,25996,1245594,1151628,93966,
CVD EQUIPMENT CORP,126601103,431,129291,120301,8990,
CVR ENERGY INC,12662P108,92673,2104769,2104769,0,CVI
CVS HEALTH CORP,126650100,25182,399268,399268,0,
CYMABAY THERAPEUTICS INC,23257D103,204,39920,10100,29820,
CYNERGISTEK INC,23258P105,386,125224,120926,4298,
CYTOMX THERAPEUTICS INC,23284F105,11308,1532300,1532300,0,
DAILY JOURNAL CORP,233912104,446,1800,1800,0,
DAKTRONICS INC,234264109,9527,1290000,1290000,0,
DARDEN RESTAURANTS INC,237194105,107213,906892,715703,191189,DRI
DARE BIOSCIENCE INC,23666P101,166,212601,208276,4325,
DASEKE INC,23753F107,563,225100,225100,0,
DATA I O CORP,237690102,2566,658914,657199,1715,
DAVITA INC,23918K108,36816,645097,57648,587449,
DAWSON GEOPHYSICAL CO NEW,239360100,3687,1722774,1722774,0,
DAXOR CORP,239467103,107,11100,11100,0,
DECIPHERA PHARMACEUTICALS IN,24344T101,4877,143700,47848,95852,
DELTA APPAREL INC,247368103,295,12400,12400,0,
DEL TACO RESTAURANTS INC,245496104,8599,841000,841000,0,
DELUXE CORP,248019101,25519,519105,519105,0,DLX
DENNYS CORP,24869P104,82669,3631411,3577900,53511,
DENTSPLY SIRONA INC,24906P109,8176,153358,0,153358,
DERMIRA INC,24983L104,5273,825198,697295,127903,DERM
DESCARTES SYS GROUP INC,249906108,23384,579700,317900,261800,DSGX
DESTINATION MATERNITY CORP,25065D100,335,807607,807607,0,
DESTINATION XL GROUP INC,25065K104,279,165062,165062,0,
DEVON ENERGY CORP NEW,25179M103,137363,5709192,4586595,1122597,DVN
DEXCOM INC,252131107,8268,55400,55400,0,
DGSE COMPANIES INC,23323G106,155,128808,124124,4684,
DHI GROUP INC,23331S100,11291,2932700,2932700,0,
DIAMONDROCK HOSPITALITY CO,252784301,11067,1079684,601914,477770,
DIANA SHIPPING INC,Y2066G104,6178,1827670,1745831,81839,
DICERNA PHARMACEUTICALS INC,253031108,6970,485400,485400,0,
DIEBOLD NXDF INC,253651103,5575,497807,383548,114259,
DIGI INTL INC,253798102,10527,772884,730800,42084,
DIGITAL RLTY TR INC,253868103,10403,80143,1681,78462,
DIME CMNTY BANCSHARES,253922108,14722,687600,687600,0,
DINE BRANDS GLOBAL INC,254423106,64064,844500,844500,0,
DIODES INC,254543101,6399,159380,30568,128812,
DIPLOMAT PHARMACY INC,25456K101,1004,204900,113152,91748,
DISCOVER FINL SVCS,254709108,44891,553600,16223,537377,
DIVERSIFIED RSTRNT HLDGS INC,25532M105,611,1034821,1027126,7695,
DLH HLDGS CORP,23335Q100,1409,315970,250898,65072,
DMC GLOBAL INC,23291C103,21777,495168,463031,32137,
DNB FINL CORP,233237106,1665,37400,27000,10400,
DOCUSIGN INC,256163106,42397,684700,129895,554805,
DOLLAR GEN CORP NEW,256677105,145176,913400,464957,448443,
DOLLAR TREE INC,256746108,121089,1060698,1060698,0,
DOMINION ENERGY INC,25746U109,10551,130200,130200,0,
DOMINOS PIZZA INC,25754A201,418493,1711000,1711000,0,
DONALDSON INC,257651109,3387,65029,4937,60092,
DONNELLEY R R & SONS CO,257867200,257,68093,3100,64993,
DOUGLAS DYNAMICS INC,25960R105,2041,45800,22900,22900,
DOUGLAS EMMETT INC,25960P109,207374,4841800,4481782,360018,
DOVA PHARMACEUTICALS INC,25985T102,8340,298400,298400,0,
DOVER CORP,260003108,10314,103600,3845,99755,
DOVER MOTORSPORTS INC,260174107,823,415643,406882,8761,
D R HORTON INC,23331A109,71482,1356138,424550,931588,
DRIL QUIP INC,262037104,5214,103900,7734,96166,DRQ
DSP GROUP INC,23332B106,15179,1077694,1032600,45094,
DTE ENERGY CO,233331107,92314,694299,481879,212420,
DUCOMMUN INC DEL,264147109,24219,571200,567200,4000,
DUNKIN BRANDS GROUP INC,265504100,19840,250000,56959,193041,
DUPONT DE NEMOURS INC,26614N102,19564,274355,100151,174204,
DURECT CORP,266605104,7381,4011521,3422110,589411,
DYCOM INDS INC,267475101,15068,295170,213561,81609,
EAGLE BANCORP INC MD,268948106,2011,45080,26547,18533,
EAGLE BANCORP MONT INC,26942G100,1051,60032,51468,8564,
EAGLE MATERIALS INC,26969P108,1449,16100,16100,0,
EAGLE PHARMACEUTICALS INC,269796108,2053,36300,36300,0,
EASTERLY GOVT PPTYS INC,27616P103,48133,2259787,1932076,327711,
EASTERN CO,276317104,5406,217810,215839,1971,
EAST WEST BANCORP INC,27579R104,25034,565233,466782,98451,
EBAY INC,278642103,444853,11412328,11018188,394140,
ECHO GLOBAL LOGISTICS INC,27875T101,4401,194300,194300,0,
EDESA BIOTECH INC,27966L108,98,15753,13873,1880,
EDISON INTL,281020107,297524,3944891,3944891,0,
EDUCATIONAL DEV CORP,281479105,1323,214024,214024,0,
EIGER BIOPHARMACEUTICALS INC,28249U105,2064,201329,201329,0,
ELDORADO GOLD CORP NEW,284902509,46549,5992069,5620829,371240,
ELECTROMED INC,285409108,820,124124,102676,21448,
ELECTRO-SENSORS INC,285233102,388,100800,100800,0,
ELEVATE CREDIT INC,28621V101,4849,1151787,992798,158989,
E L F BEAUTY INC,26856L103,7414,423400,370738,52662,
ELLINGTON FINANCIAL INC,28852N109,1568,86800,83,86717,
ELMIRA SVGS BK ELMIRA N Y,289660102,367,26085,9571,16514,
ELOXX PHARMACEUTICALS INC,29014R103,92,20310,20310,0,
EL POLLO LOCO HLDGS INC,268603107,409,37300,37300,0,
EMCOR GROUP INC,29084Q100,3712,43100,7072,36028,
EMERALD EXPOSITIONS EVENTS I,29103B100,2436,250400,163244,87156,
EMERGENT BIOSOLUTIONS INC,29089Q105,51460,984311,984311,0,
EMERSON ELEC CO,291011104,10156,151900,0,151900,
EMPLOYERS HOLDINGS INC,292218104,18539,425400,387114,38286,
EMX RTY CORP,26873J107,295,216502,0,216502,
ENANTA PHARMACEUTICALS INC,29251M106,39827,662900,662900,0,
ENBRIDGE INC,29250N105,124373,3545424,3184123,361301,
ENCANA CORP,292505104,81715,17764100,17764100,0,
ENCOMPASS HEALTH CORP,29261A100,22814,360532,360532,0,
ENCORE WIRE CORP,292562105,5968,106037,95600,10437,
ENDEAVOUR SILVER CORP,29258Y103,13618,6134125,6134125,0,
ENDURANCE INTL GROUP HLDGS I,29272B105,12266,3271000,3271000,0,
ENERGY RECOVERY INC,29270J100,919,99200,30200,69000,
ENERPLUS CORP,292766102,2825,379757,154632,225125,
ENERSYS,29275Y102,5433,82400,17218,65182,
ENGLOBAL CORP,293306106,491,491428,491326,102,
ENLIVEX THERAPEUTICS LTD,M4130Y106,635,23790,23790,0,
ENNIS INC,293389102,34727,1718300,1607100,111200,
ENOVA INTL INC,29357K103,53371,2572094,2572094,0,
ENPHASE ENERGY INC,29355A107,2728,122700,122700,0,
ENPRO INDS INC,29355X107,7366,107300,82568,24732,
ENTASIS THERAPEUTICS HLDGS I,293614103,105,17700,17700,0,
ENTEGRA FINL CORP,29363J108,4825,160632,128708,31924,
ENTERGY CORP NEW,29364G103,563696,4803133,4803133,0,
ENTERPRISE BANCORP INC MASS,293668109,1635,54552,51947,2605,
ENTERPRISE FINL SVCS CORP,293712105,21418,525600,481912,43688,
ENTERPRISE PRODS PARTNERS L,293792107,8951,313191,0,313191,
ENVESTNET INC,29404K106,1695,29892,4442,25450,
ENZO BIOCHEM INC,294100102,11878,3299563,3299563,0,
EOG RES INC,26875P101,47399,638627,524342,114285,
EPIZYME INC,29428V104,2683,260088,58004,202084,
EPLUS INC,294268107,3622,47600,0,47600,
EQT CORP,26884L109,2483,233364,763,232601,
EQUINIX INC,29444U700,61487,106600,106600,0,
EQUITY LIFESTYLE PPTYS INC,29472R108,339451,2540801,2540801,0,
ESCALADE INC,296056104,1919,176260,176260,0,
ESCO TECHNOLOGIES INC,296315104,748,9400,0,9400,
ESPERION THERAPEUTICS INC NE,29664W105,5202,141900,64160,77740,
ESPEY MFG & ELECTRS CORP,296650104,3487,146987,139739,7248,
ESQUIRE FINL HLDGS INC,29667J101,494,19900,13360,6540,
ESSA BANCORP INC,29667D104,8618,524842,510405,14437,
ESSENT GROUP LTD,G3198U102,59387,1245800,1245800,0,
ESSENTIAL PPTYS RLTY TR INC,29670E107,3581,156300,67422,88878,
ESSEX PPTY TR INC,297178105,299832,917900,917900,0,
ETHAN ALLEN INTERIORS INC,297602104,18311,958700,921379,37321,
ETSY INC,29786A106,410562,7266580,7266580,0,
EURONET WORLDWIDE INC,298736109,3620,24745,2300,22445,
EVELO BIOSCIENCES INC,299734103,88,14500,14500,0,
EVEREST RE GROUP LTD,G3223R108,8037,30205,30205,0,
EVERGY INC,30034W106,465418,6992456,6992456,0,
EVERI HLDGS INC,30034T103,26342,3113700,3113700,0,
EVERSOURCE ENERGY,30040W108,158416,1853471,1853471,0,
EVERTEC INC,30040P103,76036,2435501,2362624,72877,
EVOFEM BIOSCIENCES INC,30048L104,78,15499,15499,0,
EVOLUTION PETROLEUM CORP,30049A107,14174,2427132,2408272,18860,EPM
EVOQUA WATER TECHNOLOGIES CO,30057T105,20848,1224920,1130301,94619,
EXACT SCIENCES CORP,30063P105,46974,519800,176954,342846,
EXELIXIS INC,30161Q104,262615,14849596,14510549,339047,
EXELON CORP,30161N101,59848,1238824,1092200,146624,
EXLSERVICE HOLDINGS INC,302081104,24997,373310,373310,0,EXLS
EXPEDITORS INTL WASH INC,302130109,16397,220716,1817,218899,
EXPONENT INC,30214U102,38997,557900,465067,92833,
EXPRESS INC,30219E103,9772,2840800,2719848,120952,
EXP WORLD HOLDINGS INC,30212W100,739,88129,88129,0,
EXTERRAN CORP,30227H106,10713,820300,687100,133200,
EXTRA SPACE STORAGE INC,30225T102,17383,148800,148800,0,
EXTREME NETWORKS INC,30226D106,31117,4277248,4144591,132657,
EYEPOINT PHARMACEUTICALS INC,30233G100,65,35890,35890,0,
F5 NETWORKS INC,315616102,322429,2296174,2211022,85152,
FACTSET RESH SYS INC,303075105,77131,317450,203233,114217,
FAIR ISAAC CORP,303250104,425,1400,1400,0,
FARMER BROS CO,307675108,6984,539300,539300,0,
FARMER & MERCHANTS BANCORP I,30779N105,1308,50400,50400,0,
FARMERS NATL BANC CORP,309627107,4107,283600,277991,5609,
FARMLAND PARTNERS INC,31154R109,200,29900,0,29900,
FASTENAL CO,311900104,5299,162188,3400,158788,
FB FINL CORP,30257X104,3950,105200,105200,0,
FEDERAL SIGNAL CORP,313855108,6879,210100,152100,58000,
FEDEX CORP,31428X106,23903,164200,21707,142493,
FEDNAT HLDG CO,31431B109,10975,784500,676607,107893,
FERRARI N V,N3167Y103,77995,506043,125393,380650,
FIBROCELL SCIENCE INC,315721407,2261,763754,757154,6600,
FIESTA RESTAURANT GROUP INC,31660B101,1610,154466,114927,39539,
FIFTH THIRD BANCORP,316773100,11799,430939,346677,84262,
FINANCIAL INSTNS INC,317585404,14130,468200,457352,10848,
FIREEYE INC,31816Q101,21508,1612300,1612300,0,
FIRST AMERN FINL CORP,31847R102,11123,188500,54499,134001,
FIRST BANCORP INC ME,31866P102,6125,222801,219097,3704,
FIRST BANCORP N C,318910106,22162,617314,586805,30509,
FIRST BANCSHARES INC MS,318916103,1567,48500,28625,19875,
FIRST BANK WILLIAMSTOWN NJ,31931U102,2439,225185,201555,23630,
FIRST BUS FINL SVCS INC WIS,319390100,6112,253805,239902,13903,
FIRST CAPITAL INC,31942S104,434,7500,2709,4791,
FIRSTCASH INC,33767D105,130704,1425814,1340853,84961,FCFS
FIRST CHOICE BANCORP,31948P104,874,41000,34141,6859,
FIRST CMNTY BANKSHARES INC V,31983A103,8536,263692,253224,10468,
FIRST CMNTY CORP S C,319835104,1710,87789,67199,20590,
FIRST COMWLTH FINL CORP PA,319829107,17963,1352600,1310690,41910,
FIRST DEFIANCE FINL CORP,32006W106,24313,839400,803840,35560,
FIRSTENERGY CORP,337932107,463158,9603100,9603100,0,
FIRST FINANCIAL NORTHWEST IN,32022K102,9976,674994,657121,17873,
FIRST FINL BANCORP OH,320209109,4403,179880,179880,0,
FIRST FINL CORP IND,320218100,7836,180259,180259,0,
FIRST FNDTN INC,32026V104,2074,135765,135765,0,
FIRST GTY BANCSHARES INC,32043P106,783,35350,29233,6117,
FIRST HAWAIIAN INC,32051X108,10197,381900,350264,31636,FHB
FIRST HORIZON NATL CORP,320517105,8608,531386,336456,194930,
FIRST INDUSTRIAL REALTY TRUS,32054K103,73455,1856800,1856800,0,
FIRST INTERNET BANCORP,320557101,465,21700,11952,9748,
FIRST LONG IS CORP,320734106,16107,707981,700069,7912,
FIRST MAJESTIC SILVER CORP,32076V103,13408,1474600,1224700,249900,
FIRST MERCHANTS CORP,320817109,28598,759866,735677,24189,
FIRST MID BANCSHARES INC,320866106,4560,131712,131712,0,
FIRST MIDWEST BANCORP DEL,320867104,2976,152771,107776,44995,
FIRST NORTHWEST BANCORP,335834107,7463,430905,416297,14608,FNWB
FIRST REP BK SAN FRANCISCO C,33616C100,37916,392100,100543,291557,
FIRST SAVINGS FINL GROUP INC,33621E109,714,11300,6600,4700,
FIRSTSERVICE CORP NEW,33767E202,101196,986593,959993,26600,
FIRST US BANCSHARES INC,33744V103,1285,143564,137364,6200,
FIRST UTD CORP,33741H107,1584,72002,54643,17359,
FISERV INC,337738108,4157,40127,6460,33667,
FIVE9 INC,338307101,29331,545800,188387,357413,
FIVE PRIME THERAPEUTICS INC,33830X104,5173,1334891,1301390,33501,
FIVE STAR SENIOR LIVING INC,33832D106,618,1313840,1313840,0,
FLANIGANS ENTERPRISES INC,338517105,1278,55900,55900,0,
FLEETCOR TECHNOLOGIES INC,339041105,32521,113400,2935,110465,
FLEXIBLE SOLUTIONS INTL INC,33938T104,926,392501,348484,44017,
FLEXION THERAPEUTICS INC,33938J106,581,42400,42400,0,
FLEXSTEEL INDS INC,339382103,3356,226418,222893,3525,
FLOWERS FOODS INC,343498101,56134,2426883,2166099,260784,
FLUENT INC,34380C102,900,329006,329006,0,
FLUIDIGM CORP DEL,34385P108,12711,2745360,2686800,58560,
FLUOR CORP NEW,343412102,11865,620214,111343,508871,
FLUSHING FINL CORP,343873105,12736,630360,596724,33636,
FNB CORP PA,302520101,42215,3661328,3591396,69932,
FNCB BANCORP INC,302578109,300,38400,17981,20419,
FORD MTR CO DEL,345370860,62954,6872709,263829,6608880,
FORESTAR GROUP INC,346232101,473,25880,19500,6380,FOR
FORMFACTOR INC,346375108,6154,330085,305761,24324,
FORRESTER RESH INC,346563109,29891,930018,893000,37018,
FORTERRA INC,34960W106,205,28300,0,28300,
FORTINET INC,34959E109,325800,4244400,3930254,314146,
FORTIS INC,349553107,163686,3866900,3866900,0,
FORTIVE CORP,34959J108,19910,290400,62725,227675,
FORTRESS BIOTECH INC,34960Q109,249,176619,51285,125334,
FORTUNA SILVER MINES INC,349915108,25134,8133265,7903431,229834,
FORUM ENERGY TECHNOLOGIES IN,34984V100,1079,696330,489115,207215,
FORWARD AIR CORP,349853101,1940,30439,27336,3103,
FOSSIL GROUP INC,34988V106,15846,1266650,1146577,120073,
FOSTER L B CO,350060109,15431,712100,702300,9800,
FOUNDATION BLDG MATLS INC,350392106,16931,1093000,960300,132700,
FOUR CORNERS PPTY TR INC,35086T109,1326,46900,8851,38049,
FOX FACTORY HLDG CORP,35138V102,9398,150993,75096,75897,
FRANCO NEVADA CORP,351858105,401800,4407631,4264563,143068,
FRANKLIN COVEY CO,353469109,4197,119903,107415,12488,
FRANKLIN FINL NETWORK INC,35352P104,1369,45300,25600,19700,
FRANKLIN STREET PPTYS CORP,35471R106,29273,3460200,3460200,0,
FREIGHTCAR AMER INC,357023100,656,135284,135284,0,RAIL
FREQUENCY ELECTRS INC,358010106,3223,265233,253328,11905,FEIM
FRESHPET INC,358039105,7530,151300,151300,0,
FRIEDMAN INDS INC,358435105,3206,494020,493820,200,
FRONTDOOR INC,35905A109,79010,1626718,1413100,213618,
FRONT YD RESIDENTIAL CORP,35904G107,646,55900,139,55761,
FRP HLDGS INC,30292L107,713,14838,2677,12161,
FS BANCORP INC,30263Y104,3536,67350,64452,2898,
FTI CONSULTING INC,302941109,15135,142800,41951,100849,
FTS INTERNATIONAL INC,30283W104,132,59095,59095,0,
FUEL TECH INC,359523107,1118,1133251,1108926,24325,FTEK
FULGENT GENETICS INC,359664109,1771,170480,108755,61725,
FULLER H B CO,359694106,2728,58600,11050,47550,
FULL HOUSE RESORTS INC,359678109,2289,1059744,1054299,5445,
FULTON FINL CORP PA,360271100,1609,99445,47591,51854,
FUTUREFUEL CORPORATION,36116M106,27304,2286800,2286800,0,
FVCBANKCORP INC,36120Q101,420,23900,23900,0,
GAIN CAP HLDGS INC,36268W100,4250,805000,805000,0,
GALLAGHER ARTHUR J & CO,363576109,12746,142300,173,142127,
GAMING & LEISURE PPTYS INC,36467J108,281764,7368302,6884129,484173,
GAP INC,364760108,3111,179200,0,179200,
GARRETT MOTION INC,366505105,2304,231349,231349,0,
GATX CORP,361448103,1209,15600,5587,10013,
GCP APPLIED TECHNOLOGIES INC,36164Y101,2984,155000,121354,33646,
GEMPHIRE THERAPEUTICS INC,36870A108,24,63100,63100,0,
GENCOR INDS INC,368678108,5749,495147,484324,10823,
GENERAC HLDGS INC,368736104,12307,157100,21072,136028,
GENERAL ELECTRIC CO,369604103,538366,60219960,59877091,342869,
GENERAL FIN CORP DEL,369822101,6600,746618,698840,47778,
GENERAL MLS INC,370334104,302332,5484984,5484984,0,
GENERAL MOLY INC,370373102,80,306829,306829,0,
GENERAL MTRS CO,37045V100,80451,2146500,278150,1868350,
GENESCO INC,371532102,324,8100,0,8100,
GENMARK DIAGNOSTICS INC,372309104,3366,555500,493200,62300,
GENOMIC HEALTH INC,37244C101,169692,2502100,2434155,67945,
GENPREX INC,372446104,55,68588,68588,0,
GENTEX CORP,371901109,84214,3058433,2292008,766425,
GENTHERM INC,37253A103,2784,67764,22690,45074,
GEO GROUP INC NEW,36162J106,1146,66100,66100,0,
GEOSPACE TECHNOLOGIES CORP,37364X109,3250,211434,211434,0,
GERMAN AMERN BANCORP INC,373865104,11198,349400,349400,0,
GETTY RLTY CORP NEW,374297109,81416,2539486,2509012,30474,
GIBRALTAR INDS INC,374689107,17154,373404,353300,20104,
GILDAN ACTIVEWEAR INC,375916103,14122,397600,56821,340779,
GILEAD SCIENCES INC,375558103,933857,14734258,14318124,416134,
GLADSTONE COML CORP,376536108,60959,2594000,2480400,113600,
GLADSTONE LD CORP,376549101,1680,141233,22939,118294,
GLAUKOS CORP,377322102,16509,264100,92007,172093,
GLOBAL EAGLE ENTMT INC,37951D102,11,15371,15371,0,
GLOBALSCAPE INC,37940G109,13929,1214344,1143790,70554,
GLOBAL SELF STORAGE INC,37955N106,179,37705,10868,26837,
GLOBAL WTR RES INC,379463102,2689,227125,227125,0,
GLOBE LIFE INC,37959E102,13770,143800,42276,101524,
GLOWPOINT INC,379887508,27,28227,28227,0,
GLU MOBILE INC,379890106,76,15200,15200,0,
GMS INC,36251C103,37563,1307900,1050162,257738,
GOGO INC,38046C109,5062,839400,422696,416704,
GOLDEN ENTMT INC,381013101,5460,410861,410861,0,
GOLDEN MINERALS CO,381119106,35,143900,105502,38398,
GOLDEN STAR RES LTD CDA,38119T807,6820,2384596,2384596,0,
GOLDFIELD CORP,381370105,4032,1875330,1875330,0,
GOLDMAN SACHS GROUP INC,38141G104,64200,309800,41936,267864,GS
GOLD RESOURCE CORP,38068T105,2284,748869,748869,0,
GORMAN RUPP CO,383082104,8141,234015,221900,12115,
GRACE W R & CO DEL NEW,38388F108,18733,280600,226124,54476,
GRACO INC,384109104,8329,180900,72895,108005,GGG
GRAFTECH INTL LTD,384313508,1929,150700,55567,95133,
GRAHAM CORP,384556106,9334,469979,449881,20098,
GRAHAM HLDGS CO,384637104,13321,20078,6670,13408,
GRAINGER W W INC,384802104,56518,190200,125261,64939,
GRAND CANYON ED INC,38526M106,10723,109200,13001,96199,
GRANITE PT MTG TR INC,38741L107,5163,275521,100121,175400,
GRAN TIERRA ENERGY INC,38500T101,6063,4850200,4737000,113200,
GRAPHIC PACKAGING HLDG CO,388689101,18863,1278818,255434,1023384,
GREAT AJAX CORP,38983D300,1203,77600,45515,32085,
GREAT LAKES DREDGE & DOCK CO,390607109,21164,2025301,2025301,0,
GREAT PANTHER MINING LIMITED,39115V101,1995,2828257,2806257,22000,
GREAT SOUTHN BANCORP INC,390905107,15872,278700,276354,2346,
GREAT WESTN BANCORP INC,391416104,13987,423855,407852,16003,GWB
GREEN BRICK PARTNERS INC,392709101,289,27053,753,26300,
GREEN PLAINS INC,393222104,8879,838000,838000,0,GPRE
GRIFFIN INL RLTY INC,398231100,1939,51100,39610,11490,GRIF
GRIFFON CORP,398433102,2149,102500,68800,33700,
GROUP 1 AUTOMOTIVE INC,398905109,8594,93100,34910,58190,
GROUPON INC,399473107,12981,4880205,4880205,0,GRPN
GSE SYS INC,36227K106,1010,577260,577260,0,
GSI TECHNOLOGY,36241U106,8014,914847,914847,0,
GUARANTY BANCSHARES INC TEX,400764106,2696,88127,88127,0,
GUARANTY FED BANCSHARES INC,40108P101,940,38701,37224,1477,
GUARDANT HEALTH INC,40131M109,20464,320600,95141,225459,
GUIDEWIRE SOFTWARE INC,40171V100,4932,46800,2990,43810,
GULF ISLAND FABRICATION INC,402307102,1793,335229,285614,49615,
GULF RESOURCES INC,40251W309,1276,1830162,1828362,1800,GURE
HACKETT GROUP INC,404609109,18441,1120330,1072944,47386,
HAEMONETICS CORP,405024100,331357,2626900,2429338,197562,
HAIN CELESTIAL GROUP INC,405217100,3076,143222,36986,106236,
HALLADOR ENERGY COMPANY,40609P105,1768,488458,454032,34426,
HANCOCK WHITNEY CORPORATION,410120109,9687,252962,252962,0,HWC
HANOVER INS GROUP INC,410867105,217,1600,1600,0,
HARMONIC INC,413160102,4928,748973,464199,284774,
HARPOON THERAPEUTICS INC,41358P106,374,27400,27400,0,
HARROW HEALTH INC,415858109,7040,1252706,1252706,0,
HARTE-HANKS INC,416196202,777,254641,254641,0,
HARTFORD FINL SVCS GROUP INC,416515104,1170,19300,19300,0,
HARVARD BIOSCIENCE INC,416906105,1584,515212,500600,14612,
HAVERTY FURNITURE INC,419596101,28327,1397500,1395500,2000,
HAWAIIAN ELEC INDUSTRIES,419870100,13692,300200,300200,0,
HAWAIIAN HOLDINGS INC,419879101,2314,88100,88100,0,
HAWKINS INC,420261109,4135,97300,88100,9200,
HAWTHORN BANCSHARES INC,420476103,301,12620,4576,8044,
HCA HEALTHCARE INC,40412C101,22868,189900,563,189337,
HCI GROUP INC,40416E103,4957,117919,86919,31000,
HD SUPPLY HLDGS INC,40416M105,2362,60300,26201,34099,
HEALTHEQUITY INC,42226A107,54170,947943,617816,330127,
HEALTHSTREAM INC,42222N103,15723,607300,578700,28600,
HEARTLAND EXPRESS INC,422347104,15449,718233,694029,24204,
HEARTLAND FINL USA INC,42234Q102,7489,167400,167400,0,
HECLA MNG CO,422704106,8799,4999602,1757553,3242049,
HEICO CORP NEW,422806109,14881,119164,28707,90457,
HEIDRICK & STRUGGLES INTL IN,422819102,33489,1226702,1197000,29702,
HELEN OF TROY CORP LTD,G4388N106,7995,50710,27598,23112,
HELIOS TECHNOLOGIES INC,42328H109,3945,97250,97250,0,
HELIX ENERGY SOLUTIONS GRP I,42330P107,3476,431227,108630,322597,
HELMERICH & PAYNE INC,423452101,32501,811100,246085,565015,
HENNESSY ADVISORS INC,425885100,1184,109524,95163,14361,
HENRY SCHEIN INC,806407102,11799,185812,0,185812,
HERC HLDGS INC,42704L104,31487,677000,607892,69108,
HERITAGE COMMERCE CORP,426927109,11357,966171,914819,51352,
HERITAGE CRYSTAL CLEAN INC,42726M106,14606,551167,522800,28367,
HERITAGE FINL CORP WASH,42722X106,1849,68589,53900,14689,
HERITAGE INS HLDGS INC,42727J102,6144,411000,411000,0,
HERSHEY CO,427866108,748434,4828915,4411615,417300,
HERTZ GLOBAL HLDGS INC,42806J106,101417,7327808,7327808,0,
HEXCEL CORP NEW,428291108,13691,166700,36368,130332,
HEXO CORP,428304109,138,35000,21300,13700,
HIBBETT SPORTS INC,428567101,26721,1166861,1059652,107209,
HI CRUSH INC,428337109,2578,1481784,1481784,0,
HIGHPOINT RES CORP,43114K108,13430,8446305,8446305,0,
HIGHPOWER INTL INC,43113X101,5594,1192757,1145725,47032,
HIGHWOODS PPTYS INC,431284108,111298,2476600,2185429,291171,
HILLENBRAND INC,431571108,17713,573600,352435,221165,
HILL INTERNATIONAL INC,431466101,854,285644,243098,42546,
HILL ROM HLDGS INC,431475102,24940,237000,62828,174172,
HILLTOP HOLDINGS INC,432748101,24143,1010584,1000655,9929,
HILTON WORLDWIDE HLDGS INC,43300A203,32877,353100,4453,348647,HLT
HINGHAM INSTN SVGS MASS,433323102,5160,27300,23400,3900,
HMN FINL INC,40424G108,2446,106900,106802,98,
HMS HLDGS CORP,40425J101,2471,71700,71700,0,
HNI CORP,404251100,962,27100,1191,25909,
HOLLYFRONTIER CORP,436106108,26658,496982,57435,439547,
HOLOGIC INC,436440101,41304,818068,268573,549495,
HOME BANCORP INC,43689E107,9385,240700,231800,8900,
HOME BANCSHARES INC,436893200,449,23900,23900,0,
HOME DEPOT INC,437076102,189700,817603,329678,487925,
HOMESTREET INC,43785V102,10485,383800,334200,49600,
HOMETRUST BANCSHARES INC,437872104,21289,816615,773715,42900,
HONEYWELL INTL INC,438516106,84549,499700,6675,493025,
HOOKER FURNITURE CORP,439038100,5564,259500,259500,0,
HOPE BANCORP INC,43940T109,8358,582864,526498,56366,
HORACE MANN EDUCATORS CORP N,440327104,9544,206000,172200,33800,
HORIZON BANCORP INC,440407104,20252,1166609,1125520,41089,
HORIZON GLOBAL CORP,44052W104,39,10200,10200,0,
HORNBECK OFFSHORE SVCS INC N,440543106,141,185154,185154,0,
HOST HOTELS & RESORTS INC,44107P104,64810,3748437,2015698,1732739,
HOUSTON WIRE & CABLE CO,44244K109,1257,266400,214441,51959,
HOWARD BANCORP INC,442496105,928,55600,55600,0,
HOWARD HUGHES CORP,44267D107,41433,319700,209984,109716,
HP INC,40434L105,25285,1336400,294195,1042205,
HTG MOLECULAR DIAGNOSTICS IN,40434H104,29,43500,0,43500,
HUBBELL INC,443510607,15729,119700,119700,0,
HUBSPOT INC,443573100,47833,315500,89917,225583,
HUDBAY MINERALS INC,443628102,18612,5155809,5155809,0,
HUDSON PAC PPTYS INC,444097109,65210,1948900,1744660,204240,
HUMANA INC,444859102,755842,2956318,2859107,97211,
HUNT J B TRANS SVCS INC,445658107,9189,83044,30623,52421,
HUNTSMAN CORP,447011107,7311,314300,31067,283233,
HURCO COMPANIES INC,447324104,4458,138582,115927,22655,
HURON CONSULTING GROUP INC,447462102,18448,300758,257200,43558,
HUTTIG BLDG PRODS INC,448451104,666,317106,317106,0,
HYRECAR INC,44916T107,60,24080,0,24080,
IAMGOLD CORP,450913108,78383,22986200,22970400,15800,
IBERIABANK CORP,450828108,8872,117448,88020,29428,
ICF INTL INC,44925C103,2914,34500,0,34500,
IDACORP INC,451107106,117763,1045200,978624,66576,
IDEX CORP,45167R104,14929,91095,5872,85223,
IDEXX LABS INC,45168D104,170534,627125,627125,0,
I D SYSTEMS INC,449489103,1735,317137,311762,5375,
IEC ELECTRS CORP NEW,44949L105,2092,302821,192400,110421,
IES HLDGS INC,44951W106,6435,312532,272416,40116,
II VI INC,902104108,5128,145647,10343,135304,
IMAGE SENSING SYS INC,45244C104,964,206550,206550,0,
IMAX CORP,45245E109,15749,717500,717500,0,
IMMERSION CORP,452521107,1063,139013,0,139013,
IMMUNIC INC,4525EP101,420,42029,42029,0,
IMMUNOGEN INC,45253H101,20626,8523039,8275482,247557,
IMPINJ INC,453204109,3767,122200,47516,74684,
INCYTE CORP,45337C102,203659,2743620,2466148,277472,
INDEPENDENCE CONTRACT DRIL I,453415309,680,566300,504200,62100,
INDEPENDENCE RLTY TR INC,45378A106,84620,5913316,5913316,0,
INDEPENDENT BANK CORP MASS,453836108,5923,79339,76069,3270,
INDEPENDENT BK GROUP INC,45384B106,16720,317809,280648,37161,
INDUSTRIAL SVCS OF AMERICA I,456314103,14,12400,12400,0,
INFINITY PHARMACEUTICALS INC,45665G303,1155,1120940,1120940,0,
INFORMATION SERVICES GROUP I,45675Y104,5436,2187354,2187354,0,
INFRA AND ENERGY ALTRNTIVE I,45686J104,973,208733,208733,0,
INFUSYSTEM HLDGS INC,45685K102,1767,333953,295757,38196,
INGREDION INC,457187102,13896,170000,70032,99968,
INNERWORKINGS INC,45773Y105,526,118700,118700,0,
INNOPHOS HOLDINGS INC,45774N108,29071,895600,895600,0,
INNOSPEC INC,45768S105,2478,27800,0,27800,
INNOVATIVE SOLUTIONS & SUPPO,45769N105,2178,463307,445324,17983,
INNOVIVA INC,45781M101,79911,7581687,7581687,0,
INOGEN INC,45780L104,14953,312100,189302,122798,
INPHI CORP,45772F107,47216,773404,393519,379885,
INSEEGO CORP,45782B104,3897,811810,811810,0,
INSIGHT ENTERPRISES INC,45765U103,6932,124471,23996,100475,
INSIGNIA SYS INC,45765Y105,740,755584,755584,0,
INSPERITY INC,45778Q107,7529,76346,76346,0,
INSPIRED ENTMT INC,45782N108,745,103570,103570,0,
INSPIRE MED SYS INC,457730109,4906,80400,52515,27885,
INSTALLED BLDG PRODS INC,45780R101,2345,40903,16811,24092,
INSULET CORP,45784P101,17103,103700,103700,0,
INTEL CORP,458140100,9337,181194,0,181194,
INTELLIGENT SYS CORP NEW,45816D100,4927,118597,118597,0,
INTERCONTINENTAL EXCHANGE IN,45866F104,2426,26290,48,26242,
INTERDIGITAL INC,45867G101,63964,1219067,1124780,94287,
INTERFACE INC,458665304,1740,120506,108025,12481,
INTERNATIONAL BANCSHARES COR,459044103,4148,107400,107400,0,
INTERNATIONAL BUSINESS MACHS,459200101,15473,106400,0,106400,
INTERNATIONAL MNY EXPRESS IN,46005L101,694,50478,50478,0,
INTERNATIONAL SEAWAYS INC,Y41053102,1159,60200,60200,0,
INTERNATIONAL TOWER HILL MIN,46050R102,65,124788,0,124788,
INTER PARFUMS INC,458334109,2296,32813,0,32813,
INTERPUBLIC GROUP COS INC,460690100,865,40100,0,40100,IPG
INTEST CORP,461147100,3766,809934,772054,37880,
INTEVAC INC,461148108,2879,549409,528211,21198,
INTL FCSTONE INC,46116V105,2736,66624,39238,27386,
INTL PAPER CO,460146103,21236,507800,836,506964,
INTRICON CORP,46121H109,455,23400,2501,20899,
INTUIT,461202103,13044,49048,43,49005,
INVACARE CORP,461203101,11630,1550600,1550600,0,
INVESCO MORTGAGE CAPITAL INC,46131B100,27602,1802900,1346827,456073,
INVESTAR HLDG CORP,46134L105,1627,68360,41387,26973,
INVESTORS BANCORP INC NEW,46146L101,22114,1946611,1239420,707191,
INVESTORS TITLE CO,461804106,3826,23900,22300,1600,
INVITATION HOMES INC,46187W107,169588,5727383,4800755,926628,INVH
INVIVO THERAPEUTICS HLDGS CO,46186M407,241,481354,481354,0,
IONIS PHARMACEUTICALS INC,462222100,108617,1813011,1559751,253260,
IOVANCE BIOTHERAPEUTICS INC,462260100,1117,61400,14962,46438,
IQVIA HLDGS INC,46266C105,110175,737547,564100,173447,IQV
IRADIMED CORP,46266A109,8767,417100,405900,11200,
IRIDEX CORP,462684101,813,439552,428153,11399,
IRIDIUM COMMUNICATIONS INC,46269C102,42732,2008100,2008100,0,
ISTAR INC,45031U101,18772,1438500,1310286,128214,
ITERIS INC,46564T107,5198,904774,830800,73974,
ITRON INC,465741106,26075,352561,205604,146957,
ITT INC,45073V108,4522,73900,5364,68536,
IVERIC BIO INC,46583P102,1342,1198255,1053128,145127,
JABIL INC,466313103,35266,985900,535527,450373,
JACK IN THE BOX INC,466367109,4438,48700,14898,33802,
JAKKS PAC INC,47012E106,1821,2129480,2129480,0,
J ALEXANDERS HLDGS INC,46609J106,4640,395905,360798,35107,
JAMES RIV GROUP LTD,G5005R107,28715,560400,560400,0,
JANONE INC,47089W104,141,50238,47038,3200,
JASON INDS INC,471172106,325,916371,916371,0,
JBG SMITH PPTYS,46590V100,9026,230200,133856,96344,
JEFFERIES FINL GROUP INC,47233W109,1726,93800,93800,0,
JELD-WEN HLDG INC,47580P103,6755,350200,304834,45366,JELD
JERASH HLDGS US INC,47632P101,112,15102,14731,371,
JERNIGAN CAP INC,476405105,3754,195012,24,194988,
JETBLUE AWYS CORP,477143101,157249,9388004,9006049,381955,
J JILL INC,46620W102,547,288100,288100,0,
J & J SNACK FOODS CORP,466032109,67862,353450,299085,54365,
JMP GROUP LLC,46629U107,84,24421,0,24421,
JOHNSON & JOHNSON,478160104,795719,6150250,3617071,2533179,
JOINT CORP,47973J102,1330,71471,71471,0,
JOUNCE THERAPEUTICS INC,481116101,163,48908,48908,0,
JPMORGAN CHASE & CO,46625H100,125245,1064191,707477,356714,
JUNIPER NETWORKS INC,48203R104,65008,2626600,2626600,0,
JUST ENERGY GROUP INC,48213W101,4097,1728870,1728870,0,
K12 INC,48273U102,46498,1761300,1761300,0,
KADANT INC,48282T104,5030,57300,57300,0,
KALVISTA PHARMACEUTICALS INC,483497103,221,19028,0,19028,
KAMAN CORP,483548103,4051,68122,26220,41902,
KAR AUCTION SVCS INC,48238T109,34817,1418200,344667,1073533,
KB HOME,48666K109,78893,2320390,2320390,0,
KBR INC,48242W106,790,32200,32200,0,
KEANE GROUP INC,48669A108,19596,3233723,2772731,460992,
KEARNY FINL CORP MD,48716P108,84180,6455516,6392952,62564,
KELLOGG CO,487836108,261511,4063883,3853877,210006,
KEMPER CORP DEL,488401100,18688,239746,175381,64365,
KENNAMETAL INC,489170100,9474,308200,95193,213007,
KENNEDY-WILSON HLDGS INC,489398107,2484,113300,57157,56143,
KEURIG DR PEPPER INC,49271V100,22976,840985,32708,808277,
KEWAUNEE SCIENTIFIC CORP,492854104,1570,100697,94649,6048,
KEYSIGHT TECHNOLOGIES INC,49338L103,70879,728828,387324,341504,
KEY TRONIC CORP,493144109,121,19078,12961,6117,
KEZAR LIFE SCIENCES INC,49372L100,265,80700,22595,58105,
KFORCE INC,493732101,1474,38949,6900,32049,
KILROY RLTY CORP,49427F108,6262,80400,3120,77280,
KIMBALL ELECTRONICS INC,49428J109,6426,442858,441475,1383,
KIMBERLY CLARK CORP,494368103,19347,136200,80,136120,
KIMCO RLTY CORP,49446R109,65590,3141301,3141301,0,
KINDER MORGAN INC DEL,49456B101,101302,4915200,4915200,0,
KINDRED BIOSCIENCES INC,494577109,8259,1205698,1194598,11100,
KINGSTONE COS INC,496719105,3271,383900,341800,42100,
KINROSS GOLD CORP,496902404,284656,61880899,57946477,3934422,
KIRKLAND LAKE GOLD LTD,49741E100,95829,2138893,2135700,3193,
KIRKLANDS INC,497498105,1597,1037300,1037300,0,
KKR REAL ESTATE FIN TR INC,48251K100,1680,86000,0,86000,
KLX ENERGY SERVICS HOLDNGS I,48253L106,119,13800,1800,12000,
KNOWLES CORP,49926D109,1275,62674,32117,30557,
KODIAK SCIENCES INC,50015M109,3344,232545,232545,0,
KOPIN CORP,500600101,43,62800,0,62800,
KOPPERS HOLDINGS INC,50060P106,1265,43300,14996,28304,
KOSS CORP,500692108,47,23596,23596,0,
KRAFT HEINZ CO,500754106,13385,479150,122260,356890,
KRATON CORPORATION,50077C106,20985,649900,649900,0,
KROGER CO,501044101,114606,4445544,4445544,0,
KRONOS WORLDWIDE INC,50105F105,17252,1394700,1394700,0,
KULICKE & SOFFA INDS INC,501242101,32955,1403528,1290238,113290,
KVH INDS INC,482738101,4847,455100,455100,0,
L3HARRIS TECHNOLOGIES INC,502431109,86644,415280,200376,214904,
LADENBURG THALMAN FIN SVCS I,50575Q102,729,307695,307695,0,
LAKELAND BANCORP INC,511637100,15836,1026300,993830,32470,
LAKELAND FINL CORP,511656100,11791,268100,268100,0,
LAKELAND INDS INC,511795106,6364,525092,521749,3343,
LAMB WESTON HLDGS INC,513272104,36949,508100,302989,205111,
LAM RESEARCH CORP,512807108,106948,462756,79319,383437,
LANCASTER COLONY CORP,513847103,88509,638362,594545,43817,
LANDEC CORP,514766104,456,41937,41937,0,
LANDMARK BANCORP INC,51504L107,2013,85893,79116,6777,
LANDS END INC NEW,51509F105,1057,93170,93170,0,
LANNET INC,516012101,24785,2212937,1575299,637638,
LANTHEUS HLDGS INC,516544103,41004,1635900,1635900,0,
LAREDO PETROLEUM INC,516806106,10923,4532500,4532500,0,
LAS VEGAS SANDS CORP,517834107,191858,3321634,3321634,0,
LATTICE SEMICONDUCTOR CORP,518415104,49086,2684500,2124458,560042,
LAWSON PRODS INC,520776105,2595,67000,45000,22000,
LA Z BOY INC,505336107,9083,270400,158873,111527,
L BRANDS INC,501797104,69567,3551147,3551147,0,
LCNB CORP,50181P100,3680,207416,207416,0,
LEAF GROUP LTD,52177G102,4252,1012300,1012300,0,
LEGACY TEX FINL GROUP INC,52471Y106,2122,48747,25553,23194,
LEGG MASON INC,524901105,48444,1268502,1268502,0,
LEMAITRE VASCULAR INC,525558201,2259,66100,66100,0,
LENDINGTREE INC NEW,52603B107,17477,56300,3272,53028,
LENNOX INTL INC,526107107,22159,91200,39877,51323,
LEVEL ONE BANCORP INC,52730D208,981,40661,22606,18055,
LEXINGTON REALTY TRUST,529043101,10825,1056056,527395,528661,
LGL GROUP INC,50186A108,2458,238921,210273,28648,
LHC GROUP INC,50187A107,2574,22669,1204,21465,
LIBBEY INC,529898108,1707,509700,509700,0,
LIFE STORAGE INC,53223X107,60112,570266,365511,204755,
LIFETIME BRANDS INC,53222Q103,781,88200,88200,0,
LIFEWAY FOODS INC,531914109,798,364398,359213,5185,
LILLY ELI & CO,532457108,18195,162699,162699,0,
LIMBACH HLDGS INC,53263P105,721,146332,121032,25300,
LIMELIGHT NETWORKS INC,53261M104,5841,1927686,1927686,0,
LIMONEIRA CO,532746104,1105,60200,21957,38243,
LINCOLN EDL SVCS CORP,533535100,1416,680705,678397,2308,
LINDBLAD EXPEDITIONS HLDGS I,535219109,23454,1399379,1350476,48903,LIND
LINDSAY CORP,535555106,13026,140287,140287,0,
LIPOCINE INC NEW,53630X104,1711,608772,608772,0,
LIQUIDIA TECHNOLOGIES INC,53635D202,135,37900,10147,27753,
LIQUIDITY SERVICES INC,53635B107,17440,2356754,2356754,0,
LIVE NATION ENTERTAINMENT IN,538034109,31012,467466,104701,362765,
LIVE OAK BANCSHARES INC,53803X105,243,13400,0,13400,
LIVERAMP HLDGS INC,53815P108,7736,180078,145143,34935,
LKQ CORP,501889208,3031,96386,25724,70662,
LOCKHEED MARTIN CORP,539830109,17159,43991,2775,41216,
LOGMEIN INC,54142L109,56102,790612,790612,0,
LOOP INDS INC,543518104,217,16900,200,16700,
LORAL SPACE & COMMUNICATNS I,543881106,3258,78700,44200,34500,
LOUISIANA PAC CORP,546347105,70742,2878018,2878018,0,
LOWES COS INC,548661107,148380,1349400,242416,1106984,
LPL FINL HLDGS INC,50212V100,7191,87800,87800,0,
LRAD CORP,50213V109,1394,416161,363754,52407,
LSB INDS INC,502160104,2085,402499,402499,0,
LSI INDS INC,50216C108,4445,851571,808321,43250,
LTC PPTYS INC,502175102,2433,47500,22798,24702,
LUBYS INC,549282101,619,325484,323553,1931,
LULULEMON ATHLETICA INC,550021109,123104,639400,309534,329866,
LUMBER LIQUIDATORS HLDGS INC,55003T107,160,16200,8653,7547,
LUMINEX CORP DEL,55027E102,45858,2220742,2195302,25440,
LUNA INNOVATIONS,550351100,8757,1512507,1318873,193634,
LUTHER BURBANK CORP,550550107,2230,196866,160366,36500,
LYDALL INC DEL,550819106,3597,144400,137900,6500,
MACATAWA BK CORP,554225102,12020,1156862,1136193,20669,
MACERICH CO,554382101,9640,305150,305150,0,
MACK CALI RLTY CORP,554489104,107116,4945325,4853053,92272,
MACKINAC FINL CORP,554571109,1203,77800,56068,21732,
MACQUARIE INFRASTRUCTURE COR,55608B105,62256,1577300,1577300,0,MIC
MACROGENICS INC,556099109,5542,434353,318378,115975,
MAGNACHIP SEMICONDUCTOR CORP,55933J203,1919,189231,0,189231,
MALVERN BANCORP INC,561409103,1693,77552,68191,9361,
MAMMOTH ENERGY SVCS INC,56155L108,70,28149,355,27794,
MANHATTAN ASSOCS INC,562750109,29199,361960,224701,137259,
MANHATTAN BRIDGE CAPITAL INC,562803106,1269,197062,145261,51801,
MANITEX INTL INC,563420108,253,38040,38040,0,
MANULIFE FINL CORP,56501R106,116469,6343914,4820076,1523838,
MARCUS CORP,566330106,370,10000,0,10000,
MARINE PRODS CORP,568427108,3406,240502,240102,400,
MARKEL CORP,570535104,251567,212850,212850,0,
MARKETAXESS HLDGS INC,57060D108,235214,718210,668555,49655,
MARLIN BUSINESS SVCS CORP,571157106,8907,353600,331087,22513,
MARTEN TRANS LTD,573075108,966,46500,46500,0,
MASCO CORP,574599106,41866,1004452,376366,628086,
MASIMO CORP,574795100,15578,104700,27567,77133,
MASONITE INTL CORP NEW,575385109,18566,320100,292127,27973,
MASTECH DIGITAL INC,57633B100,306,50938,28282,22656,
MASTEC INC,576323109,8038,123800,3199,120601,
MASTERCRAFT BOAT HLDGS INC,57637H103,11028,738900,692400,46500,
MATCH GROUP INC,57665R106,143130,2003500,2003500,0,
MATERION CORP,576690101,24041,391797,339897,51900,
MATRIX SVC CO,576853105,1007,58759,4442,54317,
MATSON INC,57686G105,236,6300,1878,4422,
MAUI LD & PINEAPPLE INC,577345101,1642,150920,150920,0,
MAXIM INTEGRATED PRODS INC,57772K101,22468,387978,147737,240241,
MAXIMUS INC,577933104,533,6900,2774,4126,
MAXLINEAR INC,57776J100,1124,50213,30903,19310,
MBIA INC,55262C100,2108,228374,146742,81632,MBI
MCDONALDS CORP,580135101,51767,241100,38105,202995,
MCGRATH RENTCORP,580589109,37042,532295,513800,18495,
MCKESSON CORP,58155Q103,8432,61700,3144,58556,
MDU RES GROUP INC,552690109,33492,1188095,1020335,167760,
MEDICINES CO,584688105,51237,1024732,409975,614757,
MEDIFAST INC,58470H101,95611,922615,922615,0,
MEDNAX INC,58502B106,16406,725300,476991,248309,
MEDPACE HLDGS INC,58506Q109,39834,473988,350140,123848,MEDP
MEIRAGTX HOLDINGS PLC,G59665102,1909,119672,82272,37400,
MENLO THERAPEUTICS INC,586858102,559,124800,124800,0,
MERCADOLIBRE INC,58733R102,46303,84000,17262,66738,
MERCANTILE BANK CORP,587376104,27175,828515,824887,3628,
MERCER INTL INC,588056101,15940,1271141,1271141,0,
MERCHANTS BANCORP IND,58844R108,1510,91275,35995,55280,
MERCK & CO INC,58933Y105,340711,4047413,4047413,0,
MERCURY GENL CORP NEW,589400100,113716,2035000,1991256,43744,
MERCURY SYS INC,589378108,10993,135435,33374,102061,
MEREDITH CORP,589433101,587,16000,1480,14520,MDP
MERIDIAN BANCORP INC MD,58958U103,38945,2077044,2077044,0,
MERIDIAN BIOSCIENCE INC,589584101,31070,3273948,3187400,86548,VIVO
MERITAGE HOMES CORP,59001A102,5846,83100,83100,0,
MERITOR INC,59001K100,2838,153400,29881,123519,
MERSANA THERAPEUTICS INC,59045L106,1211,766725,563459,203266,
MESA LABS INC,59064R109,19140,80500,64994,15506,
META FINL GROUP INC,59100U108,3541,108600,108600,0,
METHANEX CORP,59151K108,38228,1077748,1077406,342,
METHODE ELECTRS INC,591520200,22471,667980,655056,12924,
METLIFE INC,59156R108,17586,372900,98,372802,
METROPOLITAN BK HLDG CORP,591774104,2233,56783,55583,1200,
MFA FINL INC,55272X102,20604,2799395,801523,1997872,
MGE ENERGY INC,55277P104,36808,460850,460850,0,
MGIC INVT CORP WIS,552848103,69203,5501000,4951532,549468,
MGM RESORTS INTERNATIONAL,552953101,130357,4702640,3161656,1540984,
MICRON SOLUTIONS INC,59511X105,261,119200,119200,0,
MICRON TECHNOLOGY INC,595112103,537901,12553126,11262597,1290529,
MICT INC,55328R109,49,89972,89972,0,
MID AMER APT CMNTYS INC,59522J103,89269,686630,686630,0,
MIDDLEBY CORP,596278101,6438,55070,302,54768,
MIDDLESEX WATER CO,596680108,36852,567300,567300,0,
MIDLAND STS BANCORP INC ILL,597742105,2110,81000,81000,0,
MID PENN BANCORP INC,59540G107,936,36506,20932,15574,
MIDWESTONE FINL GROUP INC NE,598511103,6482,212400,212400,0,
M/I HOMES INC,55305B101,267,7100,7100,0,
MILLENDO THERAPEUTICS INC,60040X103,1430,201164,189364,11800,MLND
MILLER HERMAN INC,600544100,17619,382265,264468,117797,
MINERALS TECHNOLOGIES INC,603158106,5904,111200,67558,43642,
MINERVA NEUROSCIENCES INC,603380106,5551,716200,716200,0,
MIRAGEN THERAPEUTICS INC,60463E103,149,203711,102806,100905,
MIRATI THERAPEUTICS INC,60468T105,27728,355900,117411,238489,
MISONIX INC,604871103,3994,198700,194000,4700,
MISTRAS GROUP INC,60649T107,9014,549640,478938,70702,
MITCHAM INDS INC,606501104,1148,353350,353350,0,
MKS INSTRUMENT INC,55306N104,104633,1133869,1133869,0,
MOBILE MINI INC,60740F105,2067,56070,29219,26851,
MODEL N INC,607525102,47570,1713600,1713600,0,
MODINE MFG CO,607828100,3952,347609,297400,50209,
MOLECULAR TEMPLATES INC,608550109,619,93900,93900,0,
MOLECULIN BIOTECH INC,60855D101,1038,935264,935264,0,
MOLINA HEALTHCARE INC,60855R100,466195,4248955,4093217,155738,
MOMENTA PHARMACEUTICALS INC,60877T100,16815,1297486,1297486,0,
MONARCH CASINO & RESORT INC,609027107,8246,197803,189193,8610,
MONOLITHIC PWR SYS INC,609839105,558,3586,1592,1994,
MONOTYPE IMAGING HOLDINGS IN,61022P100,5128,258851,258851,0,
MONSTER BEVERAGE CORP NEW,61174X109,552615,9518004,9518004,0,
MOODYS CORP,615369105,39123,191000,191000,0,
MORNINGSTAR INC,617700109,97310,665870,632102,33768,
MOSYS INC,619718307,137,54176,54176,0,
MOVADO GROUP INC,624580106,7031,282836,282836,0,
MRC GLOBAL INC,55345K103,7277,599900,217409,382491,MRC
MR COOPER GROUP INC,62482R107,508,47799,0,47799,
MSB FINL CORP NEW,55352L101,1768,109800,92523,17277,
MSCI INC,55354G100,226828,1041688,993185,48503,
M & T BK CORP,55261F104,7668,48542,27520,21022,
MTS SYS CORP,553777103,13327,241218,193700,47518,
MURPHY USA INC,626755102,32695,383300,348538,34762,
MUSTANG BIO INC,62818Q104,2290,702472,702472,0,
MUTUALFIRST FINL INC,62845B104,8044,255213,255213,0,
MVB FINANCIAL CORP,553810102,410,20642,17242,3400,MVBF
MYERS INDS INC,628464109,23605,1337403,1316400,21003,
MYOMO INC,62857J102,163,264379,264379,0,
NANOMETRICS INC,630077105,36831,1129100,1129100,0,
NANOSTRING TECHNOLOGIES INC,63009R109,2839,131500,61746,69754,
NANOVIRICIDES INC,630087302,119,57841,56541,1300,
NANTHEALTH INC,630104107,288,401123,394359,6764,
NANTKWEST INC,63016Q102,1947,1595725,1595725,0,
NAPCO SEC TECHNOLOGIES INC,630402105,332,13000,13000,0,
NASDAQ INC,631103108,4749,47800,7637,40163,
NATHANS FAMOUS INC NEW,632347100,18430,256500,246300,10200,
NATIONAL BANKSHARES INC VA,634865109,3123,77970,77970,0,NKSH
NATIONAL BEVERAGE CORP,635017106,127202,2867500,2867500,0,FIZZ
NATIONAL CINEMEDIA INC,635309107,10690,1303645,1240271,63374,
NATIONAL GEN HLDGS CORP,636220303,2654,115300,0,115300,
NATIONAL HEALTHCARE CORP,635906100,53825,657600,645300,12300,
NATIONAL HEALTH INVS INC,63633D104,75263,913500,913500,0,
NATIONAL OILWELL VARCO INC,637071101,9782,461410,25186,436224,
NATIONAL PRESTO INDS INC,637215104,12437,139600,139600,0,
NATIONAL VISION HLDGS INC,63845R107,698,29000,2448,26552,
NATURAL GAS SERVICES GROUP,63886Q109,8396,655406,623306,32100,
NATURAL GROCERS BY VITAMIN C,63888U108,4718,472315,458215,14100,
NATURAL HEALTH TRENDS CORP,63888P406,6136,866717,866717,0,
NATURES SUNSHINE PRODUCTS IN,639027101,4434,534821,529465,5356,
NATUS MEDICAL INC,639050103,7597,238600,238600,0,
NAUTILUS INC,63910B102,14,10400,10400,0,
NAVIENT CORPORATION,63938C108,5587,436500,159716,276784,
NAVIGANT CONSULTING INC,63935N107,652,23323,60,23263,
NAVIOS MARITIME HLDGS INC,Y62197119,3511,729944,729944,0,
NAVISTAR INTL CORP NEW,63934E108,36453,1296804,1187794,109010,
NBT BANCORP INC,628778102,4636,126700,126700,0,
NCR CORP NEW,62886E108,1663,52700,93,52607,
NEENAH INC,640079109,313,4800,1000,3800,
NEOLEUKIN THERAPEUTICS INC,64049K104,2188,767841,649472,118369,
NEON THERAPEUTICS INC,64050Y100,284,165121,89073,76048,
NEOPHOTONICS CORP,64051T100,5413,888811,878022,10789,
NEOS THERAPEUTICS INC,64052L106,604,408162,269023,139139,
NEPTUNE WELLNESS SOLUTIONS I,64079L105,820,230130,18300,211830,
NETAPP INC,64110D104,355449,6769172,6532671,236501,
NETFLIX INC,64110L106,173498,648300,3674,644626,
NETWORK 1 TECHNOLOGIES INC,64121N109,1582,678316,637916,40400,
NEUBASE THERAPEUTICS INC,64132K102,1285,257520,257520,0,
NEURALSTEM INC,64127R500,165,98686,98686,0,
NEUROCRINE BIOSCIENCES INC,64125C109,351,3900,3900,0,
NEUROMETRIX INC,641255708,188,586659,586659,0,
NEURONETICS INC,64131A105,150,18094,18094,0,
NEW GOLD INC CDA,644535106,22165,21957182,18981582,2975600,
NEW HOME CO INC,645370107,226,51900,20207,31693,
NEW JERSEY RES,646025106,39581,875301,875301,0,
NEWLINK GENETICS CORP,651511107,4678,2941999,2941999,0,
NEWMARKET CORP,651587107,49050,103900,39039,64861,
NEW MEDIA INVT GROUP INC,64704V106,576,65404,11728,53676,
NEWMONT GOLDCORP CORPORATION,651639106,275608,7268179,7258279,9900,
NEW RELIC INC,64829B100,33097,538600,147794,390806,
NEW SR INVT GROUP INC,648691103,43130,6456570,6456570,0,
NEW YORK CMNTY BANCORP INC,649445103,46440,3700425,2462207,1238218,
NEXA RES S A,L67359106,5176,550100,550100,0,
NEXPOINT RESIDENTIAL TR INC,65341D102,58146,1243500,1239700,3800,
NEXTDECADE CORP,65342K105,164,28400,28400,0,
NEXTERA ENERGY INC,65339F101,118820,509980,509980,0,
NIC INC,62914B100,29605,1433632,1381472,52160,
NICOLET BANKSHARES INC,65406E102,5931,89095,74049,15046,
NI HLDGS INC,65342T106,1279,74601,49799,24802,
NINE ENERGY SVC INC,65441V101,385,62400,16500,45900,
NISOURCE INC,65473P105,32729,1093900,536256,557644,
NORDIC AMERICAN TANKERS LIMI,G65773106,837,387700,233000,154700,
NORFOLK SOUTHERN CORP,655844108,6342,35300,5779,29521,
NORTECH SYS INC,656553104,125,41400,41400,0,
NORTH AMERN CONSTR GROUP LTD,656811106,11999,1040600,904100,136500,
NORTHEAST BK LEWISTON ME,66405S100,6470,291844,289052,2792,
NORTHERN TECH INTL CORP,665809109,1457,118802,106721,12081,
NORTHFIELD BANCORP INC DEL,66611T108,37393,2328318,2304963,23355,
NORTHRIM BANCORP INC,666762109,7220,182000,175626,6374,
NORTHWEST BANCSHARES INC MD,667340103,28544,1741575,1741575,0,
NORTHWEST NAT HLDG CO,66765N105,36419,510500,506046,4454,
NORTHWEST PIPE CO,667746101,1607,57100,37429,19671,
NORWOOD FINANCIAL CORP,669549107,1664,52639,48365,4274,
NOVA MEASURING INSTRUMENTS L,M7516K103,65468,2060700,2021900,38800,
NOVAN INC,66988N106,612,237049,237049,0,
NOVANTA INC,67000B104,20201,247200,247200,0,
NOVUS THERAPEUTICS INC,67011N105,237,382236,297217,85019,
NOW INC,67011P100,14122,1231186,859187,371999,
NRC GROUP HLDGS CORP,629375106,532,42800,3600,39200,
NUCOR CORP,670346105,43317,850853,850853,0,
NUTRIEN LTD,67077M108,7624,152910,9500,143410,
NUVASIVE INC,670704105,354,5588,375,5213,
NUVECTRA CORP,67075N108,669,492214,492214,0,
NVIDIA CORP,67066G104,151927,872793,286176,586617,
NVR INC,62944T105,125498,33760,26423,7337,
NYMOX PHARMACEUTICAL CORP,P73398102,35,19390,6146,13244,
OBSEVA SA,H5861P103,733,88000,88000,0,
OCCIDENTAL PETE CORP,674599105,43086,968884,102721,866163,
OCEAN BIO CHEM INC,674631106,192,58600,56241,2359,
OCEANFIRST FINL CORP,675234108,29439,1247427,1247427,0,
ODONATE THERAPEUTICS INC,676079106,659,25326,94,25232,
OFFICE DEPOT INC,676220106,6672,3801465,3801465,0,
OFG BANCORP,67103X102,9736,444586,444586,0,
OGE ENERGY CORP,670837103,58227,1283100,1283100,0,
OHIO VY BANC CORP,677719106,1839,50400,43601,6799,
OIL DRI CORP AMER,677864100,13249,389004,389004,0,
OIL STS INTL INC,678026105,1887,141900,15737,126163,
OLD LINE BANCSHARES INC,67984M100,12217,421140,411393,9747,
OLD POINT FINL CORP,680194107,920,38635,27535,11100,
OLD REP INTL CORP,680223104,140915,5978593,5978593,0,
OLD SECOND BANCORP INC ILL,680277100,14413,1179425,1143551,35874,
OLLIES BARGAIN OUTLT HLDGS I,681116109,1448,24700,9572,15128,
OMEGA FLEX INC,682095104,2730,26700,26700,0,
OMEGA HEALTHCARE INVS INC,681936100,96651,2312778,2312778,0,
OMNOVA SOLUTIONS INC,682129101,17474,1735221,1674021,61200,
ONCOSEC MED INC,68234L306,181,91679,91679,0,
ON DECK CAP INC,682163100,18460,5494142,5436580,57562,
ONE LIBERTY PPTYS INC,682406103,28156,1022725,981536,41189,
ONEMAIN HLDGS INC,68268W103,43381,1182697,975467,207230,
ONEOK INC NEW,682680103,26655,361714,101503,260211,
ONESPAN INC,68287N100,571,39370,0,39370,
OOMA INC,683416101,10134,974403,974403,0,
OP BANCORP,67109R109,130,13300,10300,3000,
OPEN TEXT CORP,683715106,49467,1212016,1007212,204804,OTEX
OPGEN INC,68373L307,118,16694,16694,0,
OPIANT PHARMACEUTICALS INC,683750103,229,15209,10422,4787,
OPTINOSE INC,68404V100,283,40400,40400,0,OPTN
OPTION CARE HEALTH INC,68404L102,4767,1489706,1489706,0,OPCH
OPUS BK IRVINE CALIF,684000102,4456,204704,183410,21294,
ORASURE TECHNOLOGIES INC,68554V108,34482,4616103,4595427,20676,
ORCHID IS CAP INC,68571X103,10648,1851797,1851797,0,ORC
ORGANOVO HLDGS INC,68620A104,1676,6432586,6432586,0,
ORIGIN BANCORP INC,68621T102,1842,54600,54600,0,OBNK
ORION ENERGY SYSTEMS INC,686275108,5186,1819762,1792127,27635,
ORION ENGINEERED CARBONS S A,L72967109,70135,4197196,4197196,0,
ORION GROUP HOLDINGS INC,68628V308,2007,446097,441597,4500,
ORITANI FINL CORP DEL,68633D103,35202,1989400,1989400,0,ORIT
ORMAT TECHNOLOGIES INC,686688102,62805,845400,845400,0,
ORRSTOWN FINL SVCS INC,687380105,5696,260077,256801,3276,
ORTHOFIX MED INC,68752M108,22146,417690,417690,0,
OSISKO GOLD ROYALTIES LTD,68827L101,16365,1759700,1713200,46500,
OSI SYSTEMS INC,671044105,30083,296208,158042,138166,
OTONOMY INC,68906L105,4113,1720869,1633052,87817,
OTTER TAIL CORP,689648103,49305,917300,917300,0,
OUTFRONT MEDIA INC,69007J106,107958,3886169,3658470,227699,
OVID THERAPEUTICS INC,690469101,1901,586725,565709,21016,
OWENS CORNING NEW,690742101,13379,211700,7351,204349,
OWENS & MINOR INC NEW,690732102,7280,1253034,1163271,89763,OMI
PACCAR INC,693718108,24481,349678,45492,304186,PCAR
PACIFIC DRILLING SA LUXEMBOU,L7257P205,1000,255700,255700,0,
PACIFIC ETHANOL INC,69423U305,1421,2522018,2522018,0,
PACIFIC MERCANTILE BANCORP,694552100,5760,766993,747267,19726,
PACIRA BIOSCIENCES,695127100,46259,1215100,1215100,0,
PACKAGING CORP AMER,695156109,19416,183000,0,183000,
PACWEST BANCORP DEL,695263103,14873,409279,326091,83188,
PALO ALTO NETWORKS INC,697435105,1192028,5848150,5622490,225660,PANW
P A M TRANSN SVCS INC,693149106,23187,392274,386774,5500,
PAN AMERICAN SILVER CORP,697900108,124188,7920214,7816519,103695,
PAPA JOHNS INTL INC,698813102,59923,1144668,833009,311659,
PARAMOUNT GOLD NEV CORP,69924M109,52,76356,63882,12474,
PARAMOUNT GROUP INC,69924R108,78351,5868999,5373896,495103,
PARK AEROSPACE CORP,70014A104,26774,1524697,1524697,0,
PARKE BANCORP INC,700885106,2613,117615,115039,2576,
PARKER HANNIFIN CORP,701094104,86925,481287,107398,373889,
PARK HOTELS RESORTS INC,700517105,16311,653214,603384,49830,
PARK NATL CORP,700658107,10372,109400,109400,0,
PARK OHIO HLDGS CORP,700666100,1815,60800,60800,0,
PATTERSON COMPANIES INC,703395103,2076,116504,13355,103149,
PATTERSON UTI ENERGY INC,703481101,84073,9833048,8740514,1092534,
PAYCHEX INC,704326107,50109,605401,60725,544676,
PAYLOCITY HLDG CORP,70438V106,28064,287600,150502,137098,
PAYPAL HLDGS INC,70450Y103,66484,641800,74262,567538,
PAYSIGN INC,70451A104,21735,2152019,2152019,0,
PCB BANCORP,69320M109,1409,85670,46892,38778,
PC CONNECTION INC,69318J100,1490,38300,2400,35900,
PCSB FINL CORP,69324R104,4281,214180,207176,7004,
PC-TEL INC,69325Q105,13160,1566733,1457570,109163,
PDL BIOPHARMA INC,69329Y104,20227,9364285,8537326,826959,
PDL CMNTY BANCORP,69290X101,2220,157912,143290,14622,
PDS BIOTECHNOLOGY CORP,70465T107,309,91569,91569,0,
PEABODY ENERGY CORP NEW,704551100,52622,3574853,3574853,0,
PEAPACK-GLADSTONE FINL CORP,704699107,10941,390320,372155,18165,
PEBBLEBROOK HOTEL TR,70509V100,7481,268900,268900,0,
PEGASYSTEMS INC,705573103,532,7824,723,7101,
PEMBINA PIPELINE CORP,706327103,10131,273164,75641,197523,
PENNEY J C CORP INC,708160106,116,130459,130459,0,
PENNS WOODS BANCORP INC,708430103,5741,124135,119293,4842,
PENN VA CORP NEW,70788V102,2779,95600,53847,41753,
PENNYMAC FINL SVCS INC,70932M107,17681,582000,340757,241243,
PENNYMAC MTG INVT TR,70931T103,16655,749200,389654,359546,
PENSKE AUTOMOTIVE GRP INC,70959W103,790,16700,319,16381,
PEOPLES BANCORP INC,709789101,16506,518879,510184,8695,
PEOPLES BANCORP N C INC,710577107,1646,55392,49212,6180,PEBK
PEOPLES FINL SVCS CORP,711040105,3156,69681,64854,4827,
PEOPLES UTAH BANCORP,712706209,5415,191400,179100,12300,
PEOPLES UTD FINL INC,712704105,15621,999115,999115,0,
PEPSICO INC,713448108,414842,3025836,2732992,292844,
PERCEPTRON INC,71361F100,3057,637935,633304,4631,
PERFORMANCE FOOD GROUP CO,71377A103,5535,120300,16968,103332,
PERFORMANCE SHIPPING INC,Y67305105,185,200117,200117,0,
PERFORMANT FINL CORP,71377E105,1046,950739,950739,0,
PERMA PIPE INTL HLDGS INC,714167103,2246,233278,213181,20097,
PERSPECTA INC,715347100,23072,883300,499658,383642,PRSP
PETMED EXPRESS INC,716382106,29232,1622200,1622200,0,
PFENEX INC,717071104,12861,1523805,1463025,60780,
PFIZER INC,717081103,153899,4283300,4283300,0,
PGT INNOVATIONS INC,69336V101,51949,3008029,3008029,0,
PHASEBIO PHARMACEUTICALS INC,717224109,234,56200,65,56135,
PHILIP MORRIS INTL INC,718172109,32574,429000,0,429000,
PHILLIPS 66,718546104,21289,207900,143974,63926,
PHIO PHARMACEUTICALS CORP,71880W204,13,48677,48677,0,
PHOTRONICS INC,719405102,26874,2469997,2469997,0,
PIERIS PHARMACEUTICALS INC,720795103,7462,2188200,2188200,0,
PILGRIMS PRIDE CORP NEW,72147K108,17135,534713,368492,166221,
PINNACLE FINL PARTNERS INC,72346Q104,3431,60457,60457,0,
PINNACLE WEST CAP CORP,723484101,314473,3239650,3239650,0,
PIONEER NAT RES CO,723787107,14776,117488,14177,103311,
PIPER JAFFRAY COS,724078100,33211,440000,440000,0,
PITNEY BOWES INC,724479100,6749,1476708,740397,736311,
PLATINUM GROUP METALS LTD,72765Q882,35,23600,7000,16600,
PLUMAS BANCORP,729273102,234,11600,3646,7954,
PLX PHARMA INC,72942A107,350,68711,68711,0,
PLYMOUTH INDL REIT INC,729640102,7268,396705,297120,99585,
PNM RES INC,69349H107,138345,2656400,2612800,43600,
POLARIS INC,731068102,23270,264400,78913,185487,
POLYONE CORP,73179P106,22700,695258,397383,297875,
POOL CORPORATION,73278L105,9582,47504,2716,44788,
POST HLDGS INC,737446104,59493,562100,480952,81148,
POTBELLY CORP,73754Y100,8327,1909800,1909800,0,
POTLATCHDELTIC CORPORATION,737630103,108329,2636713,2636713,0,
POWELL INDS INC,739128106,23718,605834,554342,51492,
POWER REIT,73933H101,875,86338,72355,13983,
PPG INDS INC,693506107,55522,468500,23930,444570,
PPL CORP,69351T106,180602,5735220,4721606,1013614,
PQ GROUP HLDGS INC,73943T103,2522,158200,158200,0,
PRA GROUP INC,69354N106,4116,121800,74737,47063,
PREFERRED APT CMNTYS INC,74039L103,2706,187300,0,187300,
PREFORMED LINE PRODS CO,740444104,4116,75400,75400,0,
PREMIER FINL BANCORP INC,74050M105,4411,256888,245005,11883,
PRESIDIO INC,74102M103,203,11987,8598,3389,PSDO
PRETIUM RES INC,74139C102,13438,1166399,44400,1121999,
PRICESMART INC,741511109,44900,631500,629380,2120,
PRICE T ROWE GROUP INC,74144T108,560,4900,4900,0,
PRIMERICA INC,74164M108,2112,16600,3532,13068,
PRIMORIS SVCS CORP,74164F103,3516,179317,160100,19217,
PRIMO WTR CORP,74165N105,7031,572555,572555,0,
PROASSURANCE CORP,74267C106,42557,1056800,1022168,34632,
PROFIRE ENERGY INC,74316X101,2133,1128465,1126211,2254,
PROGRESSIVE CORP OHIO,743315103,446103,5774796,5774796,0,PGR
PROGRESS SOFTWARE CORP,743312100,59188,1555111,1495908,59203,
PROOFPOINT INC,743424103,13989,108400,92020,16380,
PROPETRO HLDG CORP,74347M108,2267,249400,6730,242670,
PROPHASE LABS INC,74345W108,370,191600,191600,0,
PROS HOLDINGS INC,74346Y103,83094,1394200,1222235,171965,
PROSPERITY BANCSHARES INC,743606105,8704,123232,122988,244,
PROTAGONIST THERAPEUTICS INC,74366E102,6667,555100,555100,0,
PROTALIX BIOTHERAPEUTICS INC,74365A101,913,4450473,4450473,0,
PROTEON THERAPEUTICS INC,74371L109,200,767422,767422,0,
PROTO LABS INC,743713109,1603,15700,1196,14504,
PROVIDENCE SVC CORP,743815102,57279,963320,926177,37143,
PROVIDENT BANCORP INC,74383X109,423,17590,9385,8205,
PROVIDENT FINL HLDGS INC,743868101,9382,452122,435488,16634,
PROVIDENT FINL SVCS INC,74386T105,32039,1306100,1306100,0,
PRUDENTIAL BANCORP INC NEW,74431A101,7490,440300,439218,1082,
PRUDENTIAL FINL INC,744320102,18521,205900,42331,163569,
PS BUSINESS PKS INC CALIF,69360J107,985,5412,187,5225,
PTC THERAPEUTICS INC,69366J200,4407,130300,20357,109943,
PUBLIC STORAGE,74460D109,372800,1519957,1406869,113088,
PUBLIC SVC ENTERPRISE GRP IN,744573106,83354,1342684,1215315,127369,
PULTE GROUP INC,745867101,19769,540867,62641,478226,
PURPLE INNOVATION INC,74640Y106,548,72800,32789,40011,PRPL
PVH CORP,693656100,46292,524675,524675,0,
PYXIS TANKERS INC,Y71726106,57,38300,27043,11257,
Q2 HLDGS INC,74736L109,10797,136900,33316,103584,
QCR HOLDINGS INC,74727A104,20870,549500,547064,2436,
QORVO INC,74736K101,73762,994906,848630,146276,
QUALCOMM INC,747525103,98432,1290400,1290400,0,
QUALYS INC,74758T303,34226,452900,353778,99122,
QUANEX BUILDING PRODUCTS COR,747619104,19035,1052800,1052800,0,
QUANTA SVCS INC,74762E102,2395,63369,128,63241,
QUARTERHILL INC,747713105,2699,2075056,1793232,281824,
QUEST DIAGNOSTICS INC,74834L100,10307,96300,19802,76498,
QUIDEL CORP,74838J101,546,8900,8900,0,
QUINTANA ENERGY SVCS INC,74875T103,82,40210,40210,0,
QUMU CORP,749063103,2498,766154,730260,35894,
QUORUM HEALTH CORP,74909E106,718,593388,593388,0,
QUOTIENT TECHNOLOGY INC,749119103,4217,539300,539300,0,
R1 RCM INC,749397105,5962,667603,667603,0,
RADIAN GROUP INC,750236101,16091,704500,521385,183115,
RADIANT LOGISTICS INC,75025X100,861,166500,96000,70500,
RADNET INC,750491102,26259,1828603,1708875,119728,
RAMBUS INC DEL,750917106,57792,4403200,4403200,0,
RANGE RES CORP,75281A109,4281,1120655,97367,1023288,
RAPID7 INC,753422104,8211,180896,33750,147146,
RAVEN INDS INC,754212108,12484,373100,373100,0,
RAYONIER ADVANCED MATLS INC,75508B104,19132,4418557,4184838,233719,
RAYONIER INC,754907103,121005,4290950,4238057,52893,
RBB BANCORP,74930B105,1028,52200,52200,0,
RBC BEARINGS INC,75524B104,9009,54300,15172,39128,
RCI HOSPITALITY HLDGS INC,74934Q108,5596,270600,270600,0,
READY CAP CORP,75574U101,290,18245,0,18245,
REALOGY HLDGS CORP,75605Y106,4691,702200,189012,513188,
RECRO PHARMA INC,75629F109,9451,853000,853000,0,
RED LION HOTELS CORP,756764106,2195,338690,307590,31100,
RED ROBIN GOURMET BURGERS IN,75689M101,1299,39066,5292,33774,
RED VIOLET INC,75704L104,774,61392,56800,4592,
REDWOOD TR INC,758075402,13960,850700,406683,444017,
REGAL BELOIT CORP,758750103,7351,100900,27261,73639,
REGENCY CTRS CORP,758849103,120891,1739690,1739690,0,
REGENERON PHARMACEUTICALS,75886F107,110632,398818,235400,163418,REGN
REGIONAL MGMT CORP,75902K106,15241,541237,455719,85518,RM
REGIONS FINL CORP NEW,7591EP100,35284,2230321,1588118,642203,
REGIS CORP MINN,758932107,44520,2201800,2201800,0,
REKOR SYS INC,759419104,46,21261,0,21261,
RELIANCE STEEL & ALUMINUM CO,759509102,36736,368612,153354,215258,
RELIANT BANCORP INC,75956B101,432,18025,18025,0,
REMARK HLDGS INC,75955K102,218,208813,208813,0,
RENAISSANCERE HOLDINGS LTD,G7496G103,176836,914115,914115,0,
RENASANT CORP,75970E107,18378,524939,524939,0,
RENT A CTR INC NEW,76009N100,114472,4438624,4437024,1600,
REPLIGEN CORP,759916109,17662,230304,143761,86543,
REPUBLIC FIRST BANCORP INC,760416107,2818,670933,664085,6848,
REPUBLIC SVCS INC,760759100,20284,234361,34900,199461,
RESMED INC,761152107,959,7100,7100,0,
RESOLUTE FST PRODS INC,76117W109,4940,1051600,944700,106900,
RESOURCES CONNECTION INC,76122Q105,2931,172542,144200,28342,
RESTAURANT BRANDS INTL INC,76131D103,427,6000,6000,0,
RETAIL OPPORTUNITY INVTS COR,76131N101,31695,1738600,1481690,256910,
RETAIL VALUE INC,76133Q102,12778,344989,287367,57622,
RETO ECO SOLUTIONS INC,G75271109,23,20105,20105,0,
RETRACTABLE TECHNOLOGIES INC,76129W105,990,861242,861242,0,
RETROPHIN INC,761299106,7892,680925,562086,118839,
REVANCE THERAPEUTICS INC,761330109,11393,876373,847312,29061,
REXAHN PHARMACEUTICALS INC,761640309,224,109104,109104,0,
REX AMERICAN RESOURCES CORP,761624105,38315,501964,501964,0,
REXFORD INDL RLTY INC,76169C100,14174,322000,221685,100315,
REXNORD CORP NEW,76169B102,9438,348893,141951,206942,
RGC RES INC,74955L103,804,27500,20641,6859,
RH,74967X103,196967,1153000,857316,295684,
RHYTHM PHARMACEUTICALS INC,76243J105,231,10700,10700,0,
RIBBON COMMUNICATIONS INC,762544104,12129,2076900,2076900,0,
RICHARDSON ELECTRS LTD,763165107,4822,831376,831286,90,
RIGNET INC,766582100,4188,540400,540400,0,
RIMINI STR INC DEL,76674Q107,1368,312349,249505,62844,
RITCHIE BROS AUCTIONEERS,767744105,30240,757900,703000,54900,
RITE AID CORP,767754872,1057,152100,152100,0,
RIVERVIEW BANCORP INC,769397100,3398,460417,427337,33080,
RIVERVIEW FINL CORP NEW,76940Q105,123,10554,3707,6847,
RLJ LODGING TR,74965L101,7976,469474,109077,360397,
ROBERT HALF INTL INC,770323103,25787,463300,159935,303365,
ROCKET PHARMACEUTICALS INC,77313F106,325,27900,0,27900,
ROCKWELL AUTOMATION INC,773903109,16150,98000,39200,58800,
ROCKY BRANDS INC,774515100,8756,263492,243598,19894,
ROCKY MTN CHOCOLATE FACTORY,77467X101,4428,476101,450633,25468,
ROGERS CORP,775133101,8175,59800,10083,49717,
ROPER TECHNOLOGIES INC,776696106,16725,46900,9410,37490,
ROSETTA STONE INC,777780107,28524,1639300,1639300,0,
ROSS STORES INC,778296103,76920,700228,92238,607990,
ROYAL BK CDA MONTREAL QUE,780087102,187332,2307977,1629126,678851,
ROYAL CARIBBEAN CRUISES LTD,V7780T103,136179,1257076,611273,645803,
ROYAL GOLD INC,780287108,42654,346188,250315,95873,
RPC INC,749660106,16211,2889703,2472046,417657,
RPM INTL INC,749685103,14388,209100,28220,180880,
RTI SURGICAL HOLDINGS INC,74975N105,3316,1163578,1137805,25773,
RTW RETAILWINDS INC,74980D100,2362,1724358,1724358,0,
RUBICON PROJ INC,78112V102,11558,1326989,1193189,133800,
RUDOLPH TECHNOLOGIES INC,781270103,25885,981987,981987,0,
RUTHS HOSPITALITY GROUP INC,783332109,5737,281000,281000,0,
RYDER SYS INC,783549108,3013,58200,3329,54871,
RYMAN HOSPITALITY PPTYS INC,78377T107,24469,299100,299100,0,
SABRE CORP,78573M104,1214,54200,11345,42855,
SACHEM CAP CORP,78590A109,1272,269500,126137,143363,
SAFE BULKERS INC,Y7388L103,7737,4420986,4164065,256921,
SAFEHOLD INC,78645L100,912,29914,29914,0,
SAFETY INS GROUP INC,78648T100,34067,336200,336200,0,
SALESFORCE COM INC,79466L302,94479,636481,29304,607177,
SANDERSON FARMS INC,800013104,143282,946817,855858,90959,
SANDY SPRING BANCORP INC,800363103,35718,1059578,1052641,6937,
SANFILIPPO JOHN B & SON INC,800422107,1575,16300,16300,0,
SANGAMO THERAPEUTICS INC,800677106,606,67000,20290,46710,
SANMINA CORPORATION,801056102,37865,1179241,1014723,164518,
SANTANDER CONSUMER USA HDG I,80283M101,42331,1659400,1263956,395444,
SAREPTA THERAPEUTICS INC,803607100,26217,348078,109979,238099,
SAUL CTRS INC,804395101,29314,537774,521874,15900,
SB FINL GROUP INC,78408D105,202,12100,4137,7963,
SB ONE BANCORP,78413T103,2556,113300,75417,37883,
SCANSOURCE INC,806037107,1892,61920,0,61920,
SCHWEITZER-MAUDUIT INTL INC,808541106,21729,580363,558754,21609,SWM
SCIENCE APPLICATNS INTL CP N,808625107,2040,23350,600,22750,
SCIENTIFIC GAMES CORP,80874P109,9719,477600,196527,281073,
SCORPIO BULKERS INC,Y7546A122,11024,1813092,1707338,105754,
SCPHARMACEUTICALS INC,810648105,658,112131,112131,0,
SCYNEXIS INC,811292101,504,473673,473673,0,
SEABOARD CORP,811543107,30936,7071,6844,227,
SEABRIDGE GOLD INC,811916105,155,12300,6600,5700,
SEACHANGE INTL INC,811699107,4094,1421615,1421615,0,
SEACOR HOLDINGS INC,811904101,60155,1278000,1278000,0,
SEACOR MARINE HLDGS INC,78413P101,551,43872,43872,0,
SEADRILL LTD,G7998G106,1198,570700,570700,0,
SEALED AIR CORP NEW,81211K100,62149,1497209,1203321,293888,
SEARS HOMETOWN & OUTLET STOR,812362101,2819,819548,758365,61183,
SEASPINE HLDGS CORP,81255T108,5557,455100,455100,0,
SEATTLE GENETICS INC,812578102,3725,43613,1788,41825,
SEAWORLD ENTMT INC,81282V100,52791,2005725,2005725,0,
SEELOS THERAPEUTICS INC,81577F109,927,1009958,1009958,0,SEEL
SEI INVESTMENTS CO,784117103,58036,979426,970892,8534,
SELECTA BIOSCIENCES INC,816212104,1110,634370,609344,25026,
SELECT BANCORP INC NEW,81617L108,1864,160661,142549,18112,
SELECTIVE INS GROUP INC,816300107,14827,197194,58333,138861,
SELECT MED HLDGS CORP,81619Q105,4023,242800,242800,0,
SELLAS LIFE SCIENCES GROUP I,81642T100,17,139290,139290,0,
SEMPRA ENERGY,816851109,52111,353030,283775,69255,
SEMTECH CORP,816850101,32992,678700,678700,0,
SENMIAO TECHNOLOGY LTD,817225105,31,84300,24500,59800,
SENSIENT TECHNOLOGIES CORP,81725T100,7750,112897,42552,70345,
SERES THERAPEUTICS INC,81750R102,4328,1079208,1079208,0,
SERVICE CORP INTL,817565104,3849,80500,80500,0,
SERVICEMASTER GLOBAL HLDGS I,81761R109,25943,464100,319831,144269,
SERVICESOURCE INTL INC,81763U100,3550,4033715,4033715,0,
SERVISFIRST BANCSHARES INC,81768T108,1561,47100,47100,0,
SHARPS COMPLIANCE CORP,820017101,2013,484944,467904,17040,
SHENANDOAH TELECOMMUNICATION,82312B106,48843,1537400,1502236,35164,
SHILOH INDS INC,824543102,1207,291511,291511,0,
SHOCKWAVE MED INC,82489T104,4543,151790,54759,97031,
SHORE BANCSHARES INC,825107105,6891,447195,421329,25866,
SHOTSPOTTER INC,82536T107,316,13700,0,13700,
SHUTTERSTOCK INC,825690100,31576,874200,840757,33443,
SI BONE INC,825704109,723,40900,40900,0,SIBN
SIERRA BANCORP,82620P102,10354,389831,385534,4297,
SIERRA ONCOLOGY INC,82640U107,1028,2631764,2631764,0,
SIERRA WIRELESS INC,826516106,10782,1007751,915300,92451,
SIFCO INDS INC,826546103,157,58100,58100,0,
SIGA TECHNOLOGIES INC,826917106,1083,211600,167028,44572,
SIGMATRON INTL INC,82661L101,1088,267390,255351,12039,
SIGNATURE BK NEW YORK N Y,82669G104,27644,231874,149807,82067,
SILGAN HOLDINGS INC,827048109,33059,1100680,923053,177627,
SILICON LABORATORIES INC,826919102,5979,53698,26311,27387,
SILVERCORP METALS INC,82835P103,20613,5299209,5009310,289899,
SIMON PPTY GROUP INC NEW,828806109,123213,791605,194400,597205,
SIMPLY GOOD FOODS CO,82900L102,64860,2237336,2004404,232932,
SIMULATIONS PLUS INC,829214105,17406,501600,501600,0,
SIRIUS XM HLDGS INC,82968B103,77913,12456125,6341566,6114559,
SITE CENTERS CORP,82981J109,4737,313500,313500,0,
SIX FLAGS ENTMT CORP NEW,83001A102,4475,88100,28871,59229,
SJW GROUP,784305104,72278,1058400,1053600,4800,
SKYLINE CHAMPION CORPORATION,830830105,536,17800,5603,12197,
SKYWEST INC,830879102,112589,1961484,1936126,25358,
SLEEP NUMBER CORP,83125X103,2029,49100,49100,0,
SL GREEN RLTY CORP,78440X101,129635,1585750,1556010,29740,SLG
SLM CORP,78442P106,16425,1861200,111588,1749612,
SMART SAND INC,83191H107,230,81200,18243,62957,
SM ENERGY CO,78454L100,9006,929400,929400,0,
SOLAREDGE TECHNOLOGIES INC,83417M104,55799,666500,411661,254839,
SOLID BIOSCIENCES INC,83422E105,334,32300,0,32300,
SOLIGENIX INC,834223307,256,269691,269691,0,
SOLITARIO ZINC CORP,8342EP107,92,329469,329469,0,
SONOCO PRODS CO,835495102,4756,81700,711,80989,
SONOS INC,83570H108,227,16900,16900,0,
SOTHEBYS,835898107,3595,63100,3197,59903,
SOTHERLY HOTELS INC,83600C103,4403,658147,603603,54544,
SOUTHERN CO,842587107,533063,8629802,8629802,0,
SOUTHERN COPPER CORP,84265V105,203,5956,1591,4365,
SOUTHERN FIRST BANCSHARES IN,842873101,6245,156701,143670,13031,
SOUTHERN MO BANCORP INC,843380106,5859,160834,144474,16360,
SOUTHERN NATL BANCORP OF VA,843395104,9073,589513,566028,23485,
SOUTH JERSEY INDS INC,838518108,546,16600,16600,0,
SOUTHSIDE BANCSHARES INC,84470P109,41233,1208810,1208810,0,
SOUTH ST CORP,840441109,6876,91310,65574,25736,
SOUTHWEST AIRLS CO,844741108,126566,2343380,2281137,62243,
SOUTHWEST GAS HOLDINGS INC,844895102,9304,102200,52493,49707,
SPAR GROUP INC,784933103,43,42000,30965,11035,
SPARTAN MTRS INC,846819100,12244,892391,756500,135891,
SPARTANNASH CO,847215100,6474,547255,418084,129171,SPTN
SPECTRUM BRANDS HLDGS INC NE,84790A105,3838,72796,16663,56133,
SPECTRUM PHARMACEUTICALS INC,84763A108,22936,2765017,2747310,17707,SPPI
SPERO THERAPEUTICS INC,84833T103,2680,252803,252803,0,
SPHERIX INC,84842R502,84,50033,50033,0,
SPIRE INC,84857L101,68326,783200,783200,0,
SPIRIT OF TEX BANCSHARES INC,84861D103,983,45600,45600,0,
SPOK HLDGS INC,84863T106,18358,1537543,1468300,69243,
SP PLUS CORP,78469C103,20113,543600,508000,35600,
SPRING BK PHARMACEUTICALS IN,849431101,515,149800,130700,19100,
SPRINT CORPORATION,85207U105,520507,84360936,84360936,0,
SPROUTS FMRS MKT INC,85208M102,132856,6869500,6869500,0,
SPS COMMERCE INC,78463M107,36152,768044,664674,103370,
SSR MNG INC,784730103,83107,5723700,5543900,179800,
STAG INDL INC,85254J102,9967,338100,33116,304984,
STANDARD MTR PRODS INC,853666105,4102,84500,84500,0,
STANDEX INTL CORP,854231107,1787,24500,0,24500,
STANTEC INC,85472N109,3139,141600,134231,7369,
STARBUCKS CORP,855244109,784169,8868686,8339305,529381,
STARTEK INC,85569C107,4280,661500,649500,12000,
STARWOOD PPTY TR INC,85571B105,11361,469084,21315,447769,
STATE AUTO FINL CORP,855707105,8381,258768,228900,29868,
S & T BANCORP INC,783859101,2426,66400,66400,0,
STEEL CONNECT INC,858098106,3548,2027196,2026554,642,
STEEL DYNAMICS INC,858119100,73052,2451400,1579322,872078,
STEIN MART INC,858375108,64,79905,79905,0,
STEPAN CO,858586100,35718,368000,349300,18700,
STERLING BANCORP INC,85917W102,2156,220905,206560,14345,
STERLING CONSTRUCTION CO INC,859241101,26813,2039000,2039000,0,
STEWARDSHIP FINL CORP,860326107,273,17500,9139,8361,
STEWART INFORMATION SVCS COR,860372101,36842,949784,898535,51249,
ST JOE CO,790148100,11221,655071,604911,50160,
STOCK YDS BANCORP INC,861025104,10135,276240,270328,5912,
STONERIDGE INC,86183P102,16443,530919,530919,0,
STORE CAP CORP,862121100,55569,1485400,911859,573541,
STRATEGIC ED INC,86272C103,89075,655544,582839,72705,
STRATTEC SEC CORP,863111100,1661,83465,76214,7251,
STREAMLINE HEALTH SOLUTIONS,86323X106,392,361650,361650,0,
STURM RUGER & CO INC,864159108,58714,1405976,1405976,0,
SUMMER INFANT INC,865646103,128,366112,366112,0,
SUMMIT FINANCIAL GROUP INC,86606G101,7230,282435,279420,3015,
SUMMIT HOTEL PPTYS INC,866082100,11488,990352,897343,93009,
SUN CMNTYS INC,866674104,70714,476350,476350,0,
SUNCOKE ENERGY INC,86722A103,27257,4832800,4832800,0,
SUNCOR ENERGY INC NEW,867224107,10388,328940,324300,4640,
SUNESIS PHARMACEUTICALS INC,867328700,60,83536,83536,0,
SUN LIFE FINL INC,866796105,34040,759900,576000,183900,
SUNLINK HEALTH SYSTEMS INC,86737U102,176,155800,155800,0,
SUNOPTA INC,8676EP108,734,407648,304800,102848,
SUNSTONE HOTEL INVS INC NEW,867892101,78954,5746317,5543377,202940,
SUNTRUST BKS INC,867914103,2023,29400,29400,0,
SUPERIOR DRILLING PRODS INC,868153107,477,488046,449781,38265,
SUPERIOR GRP OF COMPANIES IN,868358102,3600,223300,212800,10500,
SUPERNUS PHARMACEUTICALS INC,868459108,15449,562200,540709,21491,
SURFACE ONCOLOGY INC,86877M209,70,49200,25172,24028,
SURMODICS INC,868873100,44347,969538,925200,44338,
SVB FINL GROUP,78486Q101,6928,33157,28299,4858,
SVMK INC,78489X103,22702,1327600,1086835,240765,
S&W SEED CO,785135104,62,26104,26104,0,
SYKES ENTERPRISES INC,871237103,17318,565200,565200,0,
SYMANTEC CORP,871503108,933,39500,39500,0,
SYNACOR INC,871561106,2421,1729086,1729086,0,
SYNALLOY CP DEL,871565107,2499,156700,156700,0,
SYNAPTICS INC,87157D109,8694,217627,117037,100590,
SYNCHRONOSS TECHNOLOGIES INC,87157B103,7042,1304098,1251698,52400,
SYNCHRONY FINL,87165B103,32921,965700,0,965700,
SYNDAX PHARMACEUTICALS INC,87164F105,3713,497000,497000,0,
SYNLOGIC INC,87166L100,352,153672,62800,90872,
SYNNEX CORP,87162W100,35092,310828,162554,148274,
SYNOPSYS INC,871607107,29911,217934,79674,138260,
SYNTHESIS ENERGY SYS INC,871628301,53,30415,30415,0,
SYPRIS SOLUTIONS INC,871655106,636,608697,608697,0,
SYROS PHARMACEUTICALS INC,87184Q107,2975,286600,286600,0,
SYSCO CORP,871829107,142380,1793200,923732,869468,
SYSTEMAX INC,871851101,5514,250500,229500,21000,SYX
TALOS ENERGY INC,87484T108,2188,107638,107638,0,
TANDY LEATHER FACTORY INC,87538X105,95,20400,14095,6305,
TANGER FACTORY OUTLET CTRS I,875465106,2745,177300,177300,0,
TANTECH HLDGS LTD,G8675X107,721,462214,369789,92425,TANH
TARGET CORP,87612E106,444200,4154900,2617703,1537197,TGT
TASEKO MINES LTD,876511106,3478,8309553,8309553,0,
TAYLOR DEVICES INC,877163105,242,23600,23600,0,
TAYLOR MORRISON HOME CORP,87724P106,10122,390192,162077,228115,
TC ENERGY CORP,87807B107,8468,163500,163500,0,
TCF FINANCIAL CORPORATION NE,872307103,8659,227456,203957,23499,
TD AMERITRADE HLDG CORP,87236Y108,120254,2575026,2245855,329171,
TEAM INC,878155100,971,53800,53800,0,
TECH DATA CORP,878237106,12972,124442,38778,85664,
TECHNICAL COMMUNICATIONS COR,878409101,86,34393,34393,0,
TECHTARGET INC,87874R100,17930,796000,796000,0,
TEEKAY CORPORATION,Y8564W103,7616,1904065,1867865,36200,
TEGNA INC,87901J105,1827,117670,0,117670,
TEJON RANCH CO,879080109,8381,493900,404829,89071,
TELARIA INC,879181105,2610,377700,137400,240300,
TELENAV INC,879455103,7588,1587369,1587369,0,
TELUS CORP,87971M103,192544,5405500,4843382,562118,
TEMPUR SEALY INTL INC,88023U101,7272,94200,15041,79159,
TENABLE HLDGS INC,88025T102,1994,89100,7704,81396,
TENNANT CO,880345103,679,9600,2000,7600,
TERADATA CORP DEL,88076W103,96466,3111800,3111800,0,
TERADYNE INC,880770102,321935,5559225,5098902,460323,
TEREX CORP NEW,880779103,3516,135400,68428,66972,
TERRENO RLTY CORP,88146M101,5068,99200,51816,47384,
TERRITORIAL BANCORP INC,88145X108,19334,676479,658945,17534,
TESLA INC,88160R101,161624,671001,484366,186635,
TESSCO TECHNOLOGIES INC,872386107,6895,479800,449000,30800,
TETRA TECHNOLOGIES INC DEL,88162F105,2295,1141716,1129186,12530,
TEXAS CAPITAL BANCSHARES INC,88224Q107,24019,439500,301315,138185,
TEXAS INSTRS INC,882508104,62139,480800,0,480800,
TEXAS ROADHOUSE INC,882681109,19898,378872,135963,242909,TXRH
TFS FINL CORP,87240R107,117939,6544900,6544900,0,
TG THERAPEUTICS INC,88322Q108,611,108794,26217,82577,
THERMON GROUP HLDGS INC,88362T103,14801,644100,555600,88500,
THIRD PT REINS LTD,G8827U100,15894,1591026,1159216,431810,
THOR INDS INC,885160101,20124,355300,58798,296502,
TILE SHOP HLDGS INC,88677Q109,2523,790900,790900,0,TTSH
TIMBERLAND BANCORP INC,887098101,11120,404369,398505,5864,
TIMKEN CO,887389104,3442,79100,8368,70732,
TIMKENSTEEL CORP,887399103,125,19800,0,19800,
TIPTREE INC,88822Q103,538,73858,21568,52290,
TITAN INTL INC ILL,88830M102,8974,3323700,3323700,0,
TITAN MACHY INC,88830R101,5074,353809,286300,67509,
TIVITY HEALTH INC,88870R102,1427,85797,14584,71213,
TIVO CORP,88870P106,10620,1394635,1353690,40945,
TJX COS INC NEW,872540109,38165,684700,145199,539501,
TOCAGEN INC,888846102,256,386258,0,386258,
TOMPKINS FINANCIAL CORPORATI,890110109,17510,215822,213892,1930,
TOOTSIE ROLL INDS INC,890516107,12546,337797,324597,13200,
TOPBUILD CORP,89055F103,5670,58800,11415,47385,
TORO CO,891092108,2815,38400,38400,0,
TOWNEBANK PORTSMOUTH VA,89214P109,32725,1176942,1176942,0,TOWN
TOWN SPORTS INTL HLDGS INC,89214A102,3356,2046552,2046552,0,CLUB
TPG RE FIN TR INC,87266M107,18133,913946,805616,108330,
TRACON PHARMACEUTICALS INC,89237H100,576,1287873,1287873,0,
TRACTOR SUPPLY CO,892356106,70860,783500,165700,617800,
TRANSACT TECHNOLOGIES INC,892918103,4906,403766,396303,7463,
TRANSALTA CORP,89346D107,12098,1860641,1489241,371400,
TRANSCAT INC,893529107,1255,48986,37886,11100,TRNS
TRANSDIGM GROUP INC,893641100,26867,51600,18527,33073,
TRANSGLOBE ENERGY CORP,893662106,4082,3069467,2943831,125636,TGA
TRECORA RES,894648104,693,76785,76785,0,
TREDEGAR CORP,894650100,1569,80400,53600,26800,
TREVENA INC,89532E109,2040,2109129,1847849,261280,
TRIBUNE PUBG CO NEW,89609W107,5849,681700,681700,0,
TRICO BANCSHARES,896095106,25930,714338,700946,13392,
TRILOGY METALS INC NEW,89621C105,383,230528,0,230528,
TRINET GROUP INC,896288107,15118,243100,243100,0,
TRINITY PL HLDGS INC,89656D101,70,17400,17400,0,
TRIPADVISOR INC,896945201,43279,1118900,1118900,0,TRIP
TRISTATE CAP HLDGS INC,89678F100,5003,237800,221200,16600,
TRIUMPH GROUP INC NEW,896818101,32435,1417600,1170217,247383,
TROVAGENE INC,897238606,468,309603,309603,0,
TRUEBLUE INC,89785X101,1941,92000,80234,11766,
TRUECAR INC,89785L107,3388,996500,996500,0,
TRUSTCO BK CORP N Y,898349105,13561,1663900,1663900,0,
TRUSTMARK CORP,898402102,2142,62804,62325,479,
TSR INC,872885207,240,75150,75150,0,
TTEC HLDGS INC,89854H102,19377,404700,404700,0,
TUPPERWARE BRANDS CORP,899896104,22582,1422955,1304360,118595,
TURNING PT BRANDS INC,90041L105,3997,173343,173343,0,
TURQUOISE HILL RES LTD,900435108,1780,3745777,0,3745777,
TWIN DISC INC,901476101,574,54193,54193,0,
TWITTER INC,90184L102,240645,5840900,5840900,0,
TWO RIV BANCORP,90207C105,2562,123587,118039,5548,
UBIQUITI INC,90353W103,58868,497782,497782,0,
UDR INC,902653104,366521,7560248,7106229,454019,
UFP TECHNOLOGIES INC,902673102,20545,532256,518956,13300,
UGI CORP NEW,902681105,81465,1620550,1620550,0,
ULTRA CLEAN HLDGS INC,90385V107,356,24300,16761,7539,
ULTRALIFE CORP,903899102,2670,308272,282396,25876,
UMB FINL CORP,902788108,12709,196800,171699,25101,
UMH PPTYS INC,903002103,1421,100900,0,100900,
UMPQUA HLDGS CORP,904214103,10516,638888,410147,228741,
UNICO AMERN CORP,904607108,130,20000,20000,0,
UNIFIRST CORP MASS,904708104,15219,78000,29548,48452,
UNION BANKSHARES INC,905400107,663,21000,21000,0,
UNION PACIFIC CORP,907818108,86287,532700,112152,420548,
UNIQUE FABRICATING INC,90915J103,174,60199,60199,0,
UNIT CORP,909218109,1202,355600,294753,60847,
UNITED AIRLINES HLDGS INC,910047109,221170,2501635,2032817,468818,
UNITED CMNTY BKS BLAIRSVLE G,90984P303,29086,1025968,1011925,14043,
UNITED CMNTY FINL CORP OHIO,909839102,21971,2038104,1978634,59470,
UNITED FINL BANCORP INC NEW,910304104,24841,1822539,1822539,0,
UNITED FIRE GROUP INC,910340108,8012,170539,154156,16383,
UNITED GUARDIAN INC,910571108,5106,269300,260800,8500,
UNITEDHEALTH GROUP INC,91324P102,353107,1624826,333430,1291396,
UNITED INS HLDGS CORP,910710102,1328,94900,26500,68400,
UNITED NAT FOODS INC,911163103,10858,942562,829225,113337,
UNITED SECURITY BANCSHARES C,911460103,2827,268712,261692,7020,
UNITED STATES CELLULAR CORP,911684108,25711,684162,650762,33400,
UNITED STATES LIME & MINERAL,911922102,17286,225960,204960,21000,
UNITED STATES STL CORP NEW,912909108,81835,7085300,4507602,2577698,
UNITED TECHNOLOGIES CORP,913017109,159252,1166509,266704,899805,
UNITED THERAPEUTICS CORP DEL,91307C102,256179,3212278,2961880,250398,
UNITIL CORP,913259107,58790,926700,920600,6100,
UNITY BANCORP INC,913290102,972,43900,43900,0,
UNIVAR SOLUTIONS INC,91336L107,22541,1085802,400070,685732,
UNIVERSAL CORP VA,913456109,56751,1035410,1011097,24313,
UNIVERSAL DISPLAY CORP,91347P105,29148,173601,40204,133397,
UNIVERSAL ELECTRS INC,913483103,5712,112223,108800,3423,
UNIVERSAL FST PRODS INC,913543104,6533,163809,93136,70673,
UNIVERSAL INS HLDGS INC,91359V107,4010,133708,130809,2899,
UNIVERSAL LOGISTICS HLDGS IN,91388P105,680,29200,1600,27600,ULH
UNIVERSAL TECHNICAL INST INC,913915104,8489,1560462,1528963,31499,
UNIVEST FINANCIAL CORPORATIO,915271100,30379,1190869,1177321,13548,
UNUM GROUP,91529Y106,30038,1010700,390532,620168,
UNUM THERAPEUTICS INC,903214104,19,13000,0,13000,
UPLAND SOFTWARE INC,91544A109,3392,97317,24334,72983,
UPWORK INC,91688F104,1611,121100,6272,114828,
URBAN EDGE PPTYS,91704F104,36756,1857300,1771544,85756,
URSTADT BIDDLE PPTYS INC,917286106,1361,72200,67409,4791,
USANA HEALTH SCIENCES INC,90328M107,113466,1659100,1659100,0,
U.S. AUTO PARTS NETWORK INC,90343C100,2275,1468006,1412782,55224,
US ECOLOGY INC,91732J102,997,15600,15600,0,
US FOODS HLDG CORP,912008109,96622,2350905,1641653,709252,
U S GOLD CORP,90291C102,54,58427,12802,45625,
USIO INC,917313108,59,29599,29599,0,
U S PHYSICAL THERAPY INC,90337L108,36699,281113,281113,0,USPH
U S SILICA HLDGS INC,90346E103,16673,1744012,1744012,0,
UTAH MED PRODS INC,917488108,22763,237514,230314,7200,
VAIL RESORTS INC,91879Q109,7100,31200,448,30752,
VALERO ENERGY CORP NEW,91913Y100,434,5088,200,4888,
VALHI INC NEW,918905100,2783,1464622,1464622,0,
VALLEY NATL BANCORP,919794107,4630,425988,375731,50257,
VALMONT INDS INC,920253101,5067,36600,1500,35100,
VALUE LINE INC,920437100,371,16300,15900,400,
VALVOLINE INC,92047W101,56550,2566962,2080392,486570,
VANDA PHARMACEUTICALS INC,921659108,42607,3208340,3135526,72814,
VAREX IMAGING CORP,92214X106,5391,188900,165981,22919,
VARIAN MED SYS INC,92220P105,13672,114800,25034,89766,
VASCULAR BIOGENICS LTD,M96883109,26,19612,0,19612,
VECTOR GROUP LTD,92240M108,125834,10565437,10075890,489547,
VECTRUS INC,92242T101,5228,128600,113800,14800,
VEECO INSTRS INC DEL,922417100,12401,1061703,1061703,0,
VENTAS INC,92276F100,288054,3944331,3944331,0,
VERA BRADLEY INC,92335C106,11619,1150407,1046200,104207,
VERACYTE INC,92337F107,4884,203500,42167,161333,
VEREIT INC,92339V100,77522,7926588,1729505,6197083,
VERINT SYS INC,92343X100,5081,118770,24314,94456,
VERISIGN INC,92343E102,1562342,8282576,7983085,299491,
VERITEX HLDGS INC,923451108,1609,66295,13272,53023,
VERITIV CORP,923454102,2936,162400,139000,23400,
VERIZON COMMUNICATIONS INC,92343V104,171694,2844493,481191,2363302,VZ
VERMILION ENERGY INC,923725105,3042,182042,5448,176594,
VERRA MOBILITY CORP,92511U102,4278,298100,75140,222960,
VERSUM MATLS INC,92532W103,52586,993500,383642,609858,
VERTEX ENERGY INC,92534K107,19,16513,16513,0,
VERTEX PHARMACEUTICALS INC,92532F100,982486,5799117,5586583,212534,
VERU INC,92536C103,854,395313,364319,30994,
V F CORP,918204108,44975,505390,63149,442241,
VIASAT INC,92552V100,23537,312493,164628,147865,
VIAVI SOLUTIONS INC,925550105,78390,5597288,5036746,560542,
VICI PPTYS INC,925652109,34575,1526500,49662,1476838,
VICOR CORP,925815102,3103,105100,84718,20382,
VIEMED HEALTHCARE INC,92663R105,90,13100,5700,7400,
VIRCO MFG CO,927651109,738,191600,191600,0,
VIRTUSA CORP,92827P102,11890,330096,330096,0,
VIRTUS INVT PARTNERS INC,92828Q109,2369,21429,18059,3370,
VISHAY INTERTECHNOLOGY INC,928298108,31388,1854013,1515353,338660,VSH
VISHAY PRECISION GROUP INC,92835K103,26113,797573,777273,20300,
VISTA OUTDOOR INC,928377100,7903,1276700,1276700,0,
VISTRA ENERGY CORP,92840M102,60845,2276273,2194047,82226,
VITAMIN SHOPPE INC,92849E101,608,93300,64,93236,
VOCERA COMMUNICATIONS INC,92857F107,3749,152100,152100,0,
VOLITIONRX LTD,928661107,378,67200,49300,17900,
VOLT INFORMATION SCIENCES IN,928703107,1150,363810,356773,7037,
VOYAGER THERAPEUTICS INC,92915B106,18465,1072901,1072901,0,
VSE CORP,918284100,389,11400,11400,0,
WABASH NATL CORP,929566107,23439,1615400,1556028,59372,
WABCO HLDGS INC,92927K102,36059,269600,25041,244559,
WALKER & DUNLOP INC,93148P102,5397,96500,95951,549,
WALMART INC,931142103,867876,7312737,7297637,15100,
WARRIOR MET COAL INC,93627C101,38097,1951696,1767971,183725,
WASHINGTON FED INC,938824109,14378,388700,388700,0,
WASHINGTON TR BANCORP,940610108,24512,507400,507400,0,
WASTE CONNECTIONS INC,94106B101,148039,1609175,1516175,93000,
WASTE MGMT INC DEL,94106L109,575,5000,215,4785,
WATERS CORP,941848103,17881,80100,80100,0,
WATERSTONE FINL INC MD,94188P101,36942,2150300,2119335,30965,
WATSCO INC,942622200,1032,6100,0,6100,
WAYSIDE TECHNOLOGY GROUP INC,946760105,4219,280696,275765,4931,WSTG
WD-40 CO,929236107,71805,391223,338736,52487,
WEBSTER FINL CORP CONN,947890109,25109,535722,448138,87584,
WEC ENERGY GROUP INC,92939U106,229659,2414921,2414921,0,
WEIS MKTS INC,948849104,3549,93051,93051,0,
WELBILT INC,949090104,6545,388175,85033,303142,WBT
WELLS FARGO CO NEW,949746101,137239,2720833,2477097,243736,
WELLTOWER INC,95040Q104,53389,588961,588961,0,
WENDYS CO,95058W100,17764,889082,362523,526559,
WERNER ENTERPRISES INC,950755108,2088,59163,1725,57438,
WESBANCO INC,950810101,32040,857364,835455,21909,
WESCO AIRCRAFT HLDGS INC,950814103,10281,933800,471387,462413,
WESCO INTL INC,95082P105,2646,55400,4500,50900,
WESTAMERICA BANCORPORATION,957090103,1967,31631,30795,836,
WESTERN ALLIANCE BANCORP,957638109,5336,115804,72497,43307,
WESTERN ASSET MTG CAP CORP,95790D105,30510,3161646,3161646,0,
WESTERN COPPER & GOLD CORP,95805V108,81,124893,40000,84893,
WESTERN DIGITAL CORP,958102105,68219,1143849,1143849,0,
WESTERN NEW ENG BANCORP INC,958892101,16588,1740627,1740627,0,
WESTERN UN CO,959802109,140678,6071543,4254782,1816761,
WEST PHARMACEUTICAL SVSC INC,955306105,52856,372700,307294,65406,
WESTROCK CO,96145D105,20910,573662,60423,513239,
WESTWOOD HLDGS GROUP INC,961765104,19193,693622,685038,8584,
WEYCO GROUP INC,962149100,2211,97800,88436,9364,
WEYERHAEUSER CO,962166104,74256,2680740,2680740,0,
WHEATON PRECIOUS METALS CORP,962879102,33448,1274700,1274700,0,
WHIRLPOOL CORP,963320106,2559,16157,162,15995,
WHITE MTNS INS GROUP LTD,G9618E107,13500,12500,3690,8810,
WHITESTONE REIT,966084204,18218,1323989,1323989,0,
WIDEPOINT CORP,967590100,365,1161591,1161591,0,
WILLAMETTE VY VINEYARD INC,969136100,679,98078,90279,7799,
WILLIAMS COS INC DEL,969457100,52412,2178374,2178374,0,
WILLIS LEASE FINANCE CORP,970646105,25576,461832,438332,23500,
WILLSCOT CORP,971375126,9382,602200,602200,0,
WINGSTOP INC,974155103,121380,1390700,1349210,41490,
WINMARK CORP,974250102,33161,188000,176600,11400,
WINNEBAGO INDS INC,974637100,5085,132600,16158,116442,
WINTRUST FINL CORP,97650W108,15899,246000,184720,61280,
WIRELESS TELECOM GROUP INC,976524108,1460,1013883,1012970,913,
WISDOMTREE INVTS INC,97717P104,11912,2279802,2279802,0,
WOODWARD INC,980745103,11946,110784,31813,78971,
WORLD ACCEP CORP DEL,981419104,36213,284000,284000,0,
WORLD FUEL SVCS CORP,981475106,33904,848873,713967,134906,
WORTHINGTON INDS INC,981811102,6886,191000,69570,121430,
WSFS FINL CORP,929328102,102878,2332833,2332833,0,
W & T OFFSHORE INC,92922P106,42532,9732638,9610807,121831,
WW INTL INC,98262P101,10533,278512,22639,255873,
WYNN RESORTS LTD,983134107,13068,120200,30501,89699,
XCEL ENERGY INC,98389B100,340331,5244730,5244730,0,
XENIA HOTELS & RESORTS INC,984017103,6939,328560,328560,0,
XENON PHARMACEUTICALS INC,98420N105,4402,488600,488600,0,
XILINX INC,983919101,82628,861604,334500,527104,
XPERI CORP,98421B100,34941,1689615,1688814,801,
XYLEM INC,98419M100,1648,20700,2513,18187,
YAMANA GOLD INC,98462Y100,75900,23872281,20661766,3210515,
YEXT INC,98585N106,20099,1264891,1139381,125510,
Y MABS THERAPEUTICS INC,984241109,1842,70700,70700,0,
YORK WTR CO,987184108,13370,306236,306236,0,
YUM BRANDS INC,988498101,29480,259900,1200,258700,
YUM CHINA HLDGS INC,98850P109,62893,1384400,1384400,0,
ZAFGEN INC,98885E103,1619,2190621,1694545,496076,
ZAYO GROUP HLDGS INC,98919V105,102378,3020000,1674423,1345577,
ZION OIL & GAS INC,989696109,20,81709,93,81616,
ZIONS BANCORPORATION N A,989701107,18988,426495,332078,94417,
ZIOPHARM ONCOLOGY INC,98973P101,559,130605,0,130605,
ZIX CORP,98974P100,25732,3554095,3554095,0,
ZOMEDICA PHARMACEUTICALS COR,98979F107,13,36220,13281,22939,
ZOVIO INC,98979V102,3442,1747100,1747100,0,
ZUMIEZ INC,989817101,1137,35900,100,35800,
ZYMEWORKS INC,98985W102,9313,375507,375507,0,
